Sango	French	Parts of Speech (e.g. A, N, V)
agîngî	abcès.
äkïlösëtôme	ankylostome.
ämîbe	amibe.
ampûle	ampoule.
ängïlîli	anguiltule.
asïäkulä	auriculaire.
äsïkärîsi	ascaride; ascaris.
bâa bê	ausculter.
bâa pâsi	souffrir.
bâa wakobêla	consulter.
babango	index.
bambî	nouveau-né.
bânde	bande.
bandêe	bander.
bängö bê	ausculation cardiaque.
bängö wakobêla	auscultation.
bängö-ngongo	lordose; scoliose.
bängö-pekô-wakobêla	suivi d'un malade.
bängö-wakobêla	consultation.
bängö-yâ	menstrues; règles.
basa	dysenterie.
bata-gbogbo	grabataire.
bätängö	préservation.
bataterê	vaccin.
bê	coeur.
bebe	foie.
bela	oindre.
bêliforôto	fontanelle.
berîberïi	béribéri.
bi na dapïämë	interner.
biakenge	virus.
biböon	bubon.
bilarazïi tî hînön	bilharzie urinaire.
bilarazïi tî vi	bilharzie intestinale.
bingö-ngo	insémination artificielle.
bingö-ngû na yâ	lavement.
biö	os.
biöbêli	pariétal.
biögô	axis; vertèbre cervical.
biökate	côte.
biököndâ	sacrum.
biökongï	occiput.
biökünï	fémur.
biöli	bofte crânienne; crâne.
biölikünï	rotule.
biöngbângbâ	maxillaire; mâchoire.
biöngongo	rachis; vertèbre.
biöpekôli	occipital.
biôke	bloc opératoire.
bôbô	placenta.
boma	endémie; peste.
bömböngö	étreinte.
börö	goitre.
bozöhînön	vessie.
bübängö-terê	difformité.
bübängö-yâ	fausse couche.
bûburû	sourd-muet.
bûngbi	associer.
buruma	bacille de Hansen; lèpre.
butöon	orgelet.
dabambî	matrice; utérus.
dädä	crampe.
dadüngö	maternité.
dagizamäa	laboratoire.
dakängängö-kä	salle de pansements.
dakängö-yorö	pharmacie.
dakängö-yorö tî âwaködörö	pharmacie communautaire.
dakängö-yorö tî kêtê ködörö	pharmacie villageoise.
dakängö-yorö-sânzîrî	pharmacie ge garde.
dakate	torse.
dakëtëngö	salle de prélèvement.
dakötäkörö	sanatorium.
daküngö	salle d'attente.
dambâgô	luette.
danganga	clinique; infirmerie.
danganga tî kötäkörö	préventorium.
dangangaburuma	léproserie.
dapärä	ovaire.
dapïämë	maison de fou.
dasânzîrî	salle de garde.
dasënë	kyste.
dasürüngö	salle d'opération.
daveke	syphilis; vérole.
dayämbängö	salle d'accueil.
dayorö	officine.
dênge	dengue.
dëngö	ablation.
dëngö	morsure.
dëngö	vomissure.
dëngö-dapärä	ovariectomie.
dëngö-fufû	pneumectomie.
dëngö-mbâgëkundü	gastrectomie.
dëngö-me	mammectomie.
dëngö-mênë	hématémèse.
dëngö-mîsahînön	néphrectomie.
dëngösên	appendicectomie.
dëngö-terê	mutilation.
dïäbête	diabète.
dïmïnïngö	atrophie.
dïrïngängö	cachexie.
dïrïngö	diminution.
dö dê	frissonner.
dokotöro	docteur.
dondö	vagin.
döngö	crise.
döngö	trémulation.
döngö-dê	frisson.
drëpä	drépanocytose.
dü	accoucher.
dû	cavite; méat.
dû tî më	condui auditif.
dudu	algie; douleur, malaise.
dudugbeyâ	pubalgie.
dudukëngë	priapisme.
dudumî	myalgie.
duduvi	entérocolite.
duduwâ	inflammation.
dûga	contusion.
dûhînön	urètre.
dûhôn	fosse nasale; narine.
dûkëngë	orifice préputial.
dûlê	orbite de oeil.
dûlêgë tî gbeyâ	canal inguinal.
dûlêgë-ngonzo	canal cystique.
dûngbângbâ	fossette.
düngö	parturition.
düngö pêrêmä	naissance prématurée.
düngö, düngö-môlengê	accouchement.
dûnyerë	orifice anal.
dûpöröterê	pore.
dûtambö	glotte.
dûturûngu	ombilic.
ëpätîte	hépatite.
fâa ganzâ (kôlï)	circoncire.
fâa ganzâ (wâlï)	exciser.
fâa zegbesa	désinfecter.
fâmbö	anoxie.
fâmbö-mênë	anoxémie.
fängbïngö-pärä	ovulation.
fängö-biö	fracture.
fängö-ganzâ	circoncision.
fängö-kâmbapärä	vasectomie.
fängö-lëndâ	clitoridectomie.
fängä-mabôko, fängö-gerê	moignon.
fängö-mbö	asphyxle; étouffement.
fängö-ngungu	démoustication.
fängö-sënë	déparasitage.
fatikêe	fatiguer.
fêvere	hypertermie.
fi	puíivériser.
fi körö	moucher (se -).
fibörôme	fibrome.
filëre	filaire.
fïngö	pulvérisation.
fïngö-pupu	expiration.
finî tî ke-pupu	anaérobiose.
finî tî yê-pupu	aérobiose.
finon	sténose.
fïnöngö	occlusion.
fïon-yângâ	haleine.
forôto	nourrisson.
fû kä	suturer.
fufû	poumon.
füngö-kä	suture.
fünngö	putréfaction.
fürüsä	bave.
gä ngangü	aggraver.
gä sänzö	suppurer.
gabä	attaque.
gamênë	rhésus -.
gamüngö-yorö	allopathie.
gamvulê	presbytie.
gangiliöon	ganglion.
gängö-ngûme	montée laiteuse.
gängö-ngûyângâ	salivation.
gängö-sänzö	suppuration.
ganzâ	circoncis; excision.
ganzâ (wâlï)	excisée.
gâze	bande de gaze.
gbâbiöterê	squelette.
gbâködörö tî sênî	région sanitaire.
gbâmüngö-yorö	soins intensifs.
gbängbängö	aggravation; gravité.
gbângo	muitigeste.
gbängö-terê	relation sexuelle.
gbânzi na danganga	hospitaliser.
gbänzïngö na danganga	hospitalisation.
gbâpopö	syndrome.
gbë	ligaturer.
gbe tî yâ	pubis.
gbegerê	plante du pied.
gbeküäli	cuir chevelu.
gbelê	pommette.
gbênga	articulation; articuler.
gbêngângbi	articuler (s'-).
gbëngö	ligature.
gbepörö	sous-cutané; épiderme.
gbepörömê	lobe de l'oreille.
gbepöröterê	derme.
gbetäsïon, ipöo	hypotension artėrielle.
gbeterêkate	hanche.
gbetï	aisselle.
gbeyâ	abdomen; bas-ventre.
gbeyângâ	menton.
gbïënngö	sénescence.
gbikï	sueur.
gbôgbôlinda	hébéphrénie; rage.
gbôkolobô	éléphantiasis des bourses.
gbôpâla	migraine.
gbôto	convulser; ponctionner.
gbôto na hôn	inhaler.
gbötöngö	avulsion, convulsion; ponction.
gbötöngö na hôn	inhalation.
gbötöngö-mênë	prise de sang; saignée.
gbötöngö-ngû	paracentèse.
gbötöngö-pupu	inspiration.
gbütängbü	annulaire.
gerê	membre inférieur; pied.
gi ndâ	dépister.
gïngö-ndâ	dépistage.
gïngö-ndâkobêla	diagnostic.
gïöngö-bê	agonie; râle.
gïrîpe	grippe; influenza.
gizamäa	examen.
gizamäa tî mênë	analyse de sang.
gizamäa tî nganga	analyse médicale.
gizamäa tî sörö	goutte salivaire.
gô	cou; gorge.
gönngö	bourdonnement.
goro	palpiter.
göröngö-bê	palpitation.
gügü	champignon.
gügümä	bégaiement.
guguma	bėgayer.
gümbängö	puberté.
gündâ-pëmbë	gencive.
gûte	goutte.
hâko yorö	médicament essentiel.
hâkokomä	lipothymie.
hän	relever de maladie.
hänngö-terê	santé.
hïnïkängö	massage.
hïnïngö	badigeonnage; onction.
hînön	urine; urée.
hôn	nez.
hôngakôbe	diète.
hônga-kôbe	régime alimentaire.
hôntï	poignet.
hünzïngö-ngangü	péremption.
ikitëre	ictère.
kä	blessure.
kä	plaie.
kä tî dapärä	salpingite.
kä tî kpôkpôrô	prurit.
kä tî lêkorobô	orchite.
kä tî pôpôrô	prurigo.
kä tî wâ	brûlure.
kä tî yângâ	stomatite.
kabanöo	asile d'aliénés.
kâi	calmer.
kâi	interrompre un traitement.
kâi kobêla	soigner; traiter.
kâi ngangü	atténuer.
käïngö-bängö-yâ	ménopause.
käïngö-kobagerê	pédicurie.
käïngö-kobapëmbë	dentisterie.
käïngö-kobêla	thérapeutique; thérapie; traitement.
käïngö-kobêla wanî	autotraitement.
käïngö-mbö	apnée.
kakö	membrane.
kaköbê	péricarde.
käkundü	gastrite.
kalê	tempe.
kalorïi	calorie.
kâmba tî turûngu	cordon ombilical.
kâmbahînön	uretère.
kâmbakä	point de suture.
kâmbamênë	vaisseau.
kändâyângâ	perlèche.
kando	pédiculose.
kânga	panser.
kânga lêgë	oblitérer.
kängängö	atrésie; bandage; pansement.
kängängö-lêgë	biocage; oblitération; obstruction.
kânga-purû	constipation.
kângbi kobêla	propager.
kansëre	cancer.
känzënë	griffure.
karïi	carie.
käsisa	névrite.
kätärâte	cataracte.
kate	cage thoracique; poitrine; thorax.
këngë	pénis; verge.
këngö-yorö	allergie.
ke-pupu	anaérobie.
kêre	angine.
keresa	globule.
kêtê	mince.
kêtê mêdondö	petites lèvres.
kêtêbiö	osselet.
kêtêdanganga	dispensaire.
kêtêdûgô	trachée.
kêtêkä	excoriation; écorchure; égratignure; éraflure.
kêtêli	microcéphale.
këtëngö	prélèvement.
kêtêsisa	nervure.
kêtêsisamû	veinule.
kêtêyangba	varicelie.
kifo	loucher.
kïföngö	loucherie.
kînda	cadavre.
kîri gbangba	recrudescence.
kïrïngö bängö-yâ	retour de couches.
kïrïngö-kobêla	rechute.
kïrïngö-sêterê	convalescence.
kïröngö-sêndâsaterê	anatomopathologie.
koä	tique.
kobabê	cardiopathie.
kobabebe	cirrhose.
kobabiakenge	virose.
kobabiö	ostéite; ostéopathie.
kobabomalê	glaucome.
kobafufû	broncho-pneumonie; pneumopathie.
kobagûênngû	potomanie.
kobagündâ-pëmbë	gingivite.
kobahîngö	albuminurie.
kobahînön	urémie.
kobakâmbamênë	fymphangite.
kobakönöngö-bê	cardiomégalie.
kobakötädûgô	œsophagite.
kobakötävi	colopathie.
kobakpëli	encéphalopathie.
kobalê	amétropie, ophtalmie.
kobali	encéphalite;, nėvropathie; psychopathie.
kobamânga	tabagisme.
kobamê	otite.
kobamênë	piroplasmose.
kobamî	myosite.
kobamozambë	trypanosomiase.
kobandâhôn	rhinopharyngite.
kobandoro	kérațtose.
kobangongo	lumbago; rachialgie.
kobangurû	ostéochondrite.
kobanyöngû	polydipsie.
kobanzara-ngû	anadipsie.
kobanzënë	onyxis.
kobapörö-terê	allergide.
kobapöröterê	dermatite; dermatose; dermite.
koba-pöröterê	favus.
kobasahînön	néphropathie.
kobasatën	puipite.
kobasënë	helminthiase; parasitose; toxoplasmose.
kobasënëvi	lambliase.
kobasênzënngö	surmenage.
kobasisa	tendinite.
kobasisätën	parodontose.
kobatägä	pancréatite.
kobatambö	laryngite.
kobatombôka	maladie mentale.
kobavïtämîni	scorbut.
kobawöngö	polypnée.
kobayângâ	candidose.
kobêla	affection, maladie.
kobêla tî äkïlösëtôme	ankylostomiase.
kobêla tî ämîbe	amibiase.
kobêla tî ängïlîli	anguillulose.
kobêla tî bilarazïi	bitharziose; schistomiase.
kobêla tî biöli	acrocéphalie.
kobêla tî fufû	fluxion de poitrine.
kobêla tî gbênga	arthrite.
kobêla tî mafüta	adipose.
kobêla tî makâko	épilepsie.
kobêla tî wâ	fièvre.
kobela tî zakara	oxyurose.
kodë	méthode.
kolêe	coaguler.
kölëngö	coagulation.
kölëngö mênë	caillot.
koleräa	choléra.
komä	apoplexie; coma.
köndôme	condom.
kongï	nuque.
könöngö	grosseur.
könöngö yâ tî kötävi	mégacôlon.
könöngö-nganzï	bronchectasie.
könöngö-ngümbä	splénomégalie.
könöngö-yâmîsa	ectasie.
koro	tousser.
körö	toux.
korobô	bourse.
körökate	bronchite.
körömëngë	hernie.
kötä boma	grandes endémies.
kötä mêdondö	grandes lèvres.
kötädûgô	oesophage.
kötä-gerê	éléphantiasis.
kötäkörö	bacille de Koch; phtisie; tuberculose.
kötäli	macrocéphale.
kötämbeto	psychose.
kötä-pëmbë	molaire.
kötäpëmbë	prémolaire.
kötätonga	trocart.
kötävi	caecum; côlon; gros intestin.
kötimênë	rhésus +.
koto	tumeur.
kôzo kobêla	primo-infection.
kôzo müngö-yorö	soins primaires.
kôzo ngo	primigeste.
kôzo purû tî forôto	méconium.
kpälë tî düngö	dystocie.
kpälë tî särängö-hînön	dysurie.
kpätë tî wöngö	dyspnée.
kpalüzôle	rubéole.
kpâtï	omoplate.
kpäyämä	prolifération.
kpayama	proliférer.
kpë kobêla	prévenir.
kpëbiö	moelle.
kpekpë	babilage.
kpëli	cerveau; encéphale.
kpëngbängö	raideur.
kpëngbängö-mî	sclérose.
kpëngö-kobêla	prévention.
kpëngö-terê	prophylaxie.
kpëpëmbë	tartre.
kpësisa	moelle épinière.
kpïngö	mourant.
kpo	injecter.
kpökä	surdité.
kpongbö	énurésie.
kpöngö	injection.
kpöngö	piqûre.
kpöngö-kate	point de côté.
kporo	fermenter.
kpûzegbesa	bacille.
kûâ	décès; mort.
küä	pilosité.
küähôn	vibrisse.
kûâlê	cil.
küäli	cheveu.
küändolê	sourcil.
küängbângbâ	favoris.
küänyö	moustache.
küäterê	poil.
küäyângâ	barbe.
kubû tî nganga	cabinet médical.
kûi	décéder.
kûi	mourir.
kûi terê	anesthésier.
küïngö-hôn	anosmie.
küïngö-këngë	impuissance sexuelle.
küïngö-ndöyingö	syncope.
küïngö-terê	anesthésie.
kundü	estomac.
kûngûlûbä	bossu.
künï	cuisse.
kûtu	bosse; écchymose.
kûtubiö	malléole.
kûtugerê	cheville.
labatäni	hôpital.
lämätîsi	rhumatisme.
lambu	tissu.
lambukä	lésion.
lê	faciès; figure; oeil; visage.
lebe	couche.
lêgë tî müngö	mode de contamination.
lêgëmê	trompe d'Eustache.
lêgëpärä	trompe de Fallope.
lêkorobô	testicule.
lele	dartre.
lëndâ	clitoris.
lengbe	polydactylie.
libê	plexus sotłaire.
lideku	épistaxis.
ligerê	ortei!.
likëngë	gland.
likünï	genou.
lime	mamelon; téton.
limëngä	apex.
lïndïsa	bactérie.
lingö-dapïämë	internement.
lïngö-sënë	infestation.
lïngö-zegbesa	infection.
lipë tî sênî	repos (sanitaire).
litï	doigt.
lobokakö	muqueuse.
löndöngö	érection.
löndöngö-bê	nausée.
lüzôle	rougeole.
mä söngö	ressentir un mal.
mabôko	avant-bras; bras; main; membre supérieur.
mabôko-na-gerê	membre.
mäïngö tî kobêla	stade.
mäïngö tî mabôko-na-gerê	développement moteur.
mäïngö-kobêla	septicémie.
mäïngö-saterê	développement physique.
mamâ	mère.
mana	miction.
mängëngö	carence.
mängëngö-lêkorobô	anorectite.
mängö-ndo	audition.
mbarafanyî	teigne.
mbëtïyorö	indication médicale; ordonnance; prescription médicale.
mboatën, karïi	carie dentaire.
mbômbôli	calvitie.
mboro	acné; bouton; pustule.
mbumalê	globe oculaire.
mbünë	boiterie; claudication; foulure.
me	mamelle; sein.
më ngo	tomber enceinte.
mê-dondö	nymphes.
mênë	sang.
mënëzîte	méningite.
mëngä	langue.
mî	muscle; substance.
mîkere	sphincter.
mîsa	organe.
mîsahînön	rein.
mîterê	musculature.
mokërëlö	hémorragie nasale.
molölömë	insommie.
möngöli	cervelet.
mü	cicatriser.
mû	prélever.
mû bataterê	vacciner.
mû kobêla	contaminer, contracter une maladie; transmettre une maladje.
mû mênë	transfuser.
mû ndo	infester.
mû ngû	hydrater; rehydrater.
mû sïöyorö	empoisonner.
mû tasïon	prendre le pouls.
mû yorö	administrer.
mû zegbesa	infecter.
müngö kobêla	transmission de maladie.
müngö-bataterê	vaccination.
müngö-kobêla	contagion; contamination, contraction d'une maladie.
müngö-mabôko tî wanganga	assistance médicale.
müngö-mênë	transfusion.
müngö-ngû	rehydratation.
müngö-sïöyorö	empoisonnement.
müngö-tâsökö	oxygénothérapie.
müngö-vïtämîni	vitaminothérapie.
müngö-yorö	administration de médicament; cure; soins.
müngö-yorö wanî	automédication.
mvulê	myopie.
nï purû	déféquer.
nïngö	excrétion.
nïngö-purû	défécation; déjection.
nökpöngö	repli cutané.
nökpöngö-terê	pli de la peau.
nörö	anomalie; déformation; malformation; tare.
ndâ	rectum.
ndâgerê	talon.
ndâgô	pharynx; voile du patais.
ndâkobêla	étíologie.
ndângängä	mollet.
ndârâ	tension.
ndârâkpû	fibre.
ndarä-na-terê	psychomoteur.
ndënë	entorse; luxation.
ndîbîlîsisa	capillaire.
ndöbê	sternum; épigastre.
ndöbêli	vertex.
ndölê	front.
ndöngâ	palais de la bouche.
ndonganga	centre de santé.
ndonganga	poste de santé.
ndörö	cicatrice.
ndoro	kératite.
ndoto	pomme d'Adam.
ndowâ	bourbouille.
ndûrûkpâ	nanisme.
nganga	guérisseur; médecine; médecine préventive.
ngängä	jambe.
nganga tî ködörö	médecine traditionnelte; tradi-practiçien.
nganga tî söngö-zo	médecine curative.
ngangasüä	acuponcture.
ngangasüä	acupuncture.
nganzï	bronche.
ngâsi	éternuement; éternuer.
ngbädä	pou de pubis.
ngbâlo	céphalée.
ngbângbâ	joue.
ngbö tî lê	onchocercose.
ngbondâ	fesse.
ngbongaterê	tronc.
ngbongbö	hernie ombilicale.
ngböngô	tibia.
ngbö-otâ	triplé.
ngbotoro	cor; durillon.
nge	amaigri; atrophier; dépérir; maigrir.
ngëngö	amaigrissement.
ngëngö	maigre; maigreur.
ngënzë	impétigo.
ngiba	lèpre tuberculoïde.
ngîgerê	arche du pied.
ngîpëmbë	arcade dentaire.
ngira	tabou.
ngîri	ronfler.
ngïrïngö	ronflement.
ngombembö	trachée-artère.
ngömbo	stérilité.
ngöngnö-lïndïsa	leptospire.
ngongo	bassin; colonne vertébrale; râble.
ngonzo	bile; fiel; venin.
ngötï	coude.
ngûhôn	morve.
ngûlê	larme.
ngûmbâ	hypertrophie de la rate.
ngûmênë	plasma sanguin.
ngûmîsa	suc.
ngumu	herpès.
ngungu	anophèle.
ngunuterê	énergie physique.
ngunuwâ	énergie calorifique.
ngurûngurû	cartilage.
ngusü	larve; puce.
ngûterê-kôli	sperme.
ngûyângâ	salive.
ngûyorö	solution.
nguzü	chique.
nyamame	mammifère.
nyerë	anus.
nyïkpïngö	mort-né.
nyö me	téter.
nyöngö-mbângi	toxicomanie.
nyöngö-me	téļtée.
nzara	faim.
nzekete	prélever.
nzënë	ongle.
nzënngö	asthénie; dégénérescence.
nzetï	vertige.
nzombö	pellicule des cheveux.
nzorôko tî terê	pigment.
opërëe	opéré.
ôro	prélever (organe).
ôro korobô	émasculer.
öröngö-korobô	émasculation.
palâta	plaque.
palü	malaria; paludisme.
pâmbotï	épaule.
panarïi	panaris.
pängä	asthme.
pâpâ	poche.
pärä	oeuf.
pärä tî môlengê (wâlï)	ovule.
päräsënë	oeuf de ver.
pärätï	apophyse.
pâsi	souffrance.
pêdûga	meurtrissure.
pekô	dos.
pêlambukä	trauma; traumatisme.
pëmbë	dent.
pendâ gizamä	résultat d'analyse.
pëndïsîte	appendicite.
pëngö-bê	bradycardie.
pêrêmä	prématuré.
pete	presser.
pïämë	démence; folie furieuse.
pïkängö-bê	pouls; pulsation.
pito	prépuce.
pökö	kwashiorkor.
polïo	poliomyélite.
pönzö	particule.
popö koba	symptôme.
popö kobêla	signe pathologique.
pöpöngbondâ	sillon fessier.
pôpôrô	chancre mou; pian.
pörö	peau; préservatif.
poroko	glabre; imberbe.
pörö-lêkorobô	scrotum.
pörömê	pavillon de l'oreille.
pöröyângâ	lèvre.
purû	déchet; excréments; selles.
radiö	radiographie.
radïo tî me	mammographie.
reä	réanimation (salle de ~).
sa körö	expectorer.
sâa na gïgî	excréter.
sängö-körö	expectoration.
sängö-yâ	ménorragie.
sangûterê-kôlï	spermatozoïde.
sânkoba	séronégatif.
sänzëngö-mênë	exsanguino-transfusion.
sânzîrî	anticorps.
sänzö	pus.
sara	démanger; picoter.
särä	gale.
sâra	gizamäa analyser.
sâra hînön	uriner.
sâra kä	ulcérer.
särängö	démangeaison; fourmillement.
särängö	picotement.
särängö-yê	attitude.
sasa	diarrhée; purge; purger.
sasa-mo-dë	diarrhée avec vomissements.
savâa	guérir; recouvrer ia santé; rétablir (se -).
sävängö	guérison.
sêkêtê	bénignité.
sêku	hoquet.
sêmbângi	toxicité.
sêmîsa	corps humain; organisme.
sêmüngö-kobêla	contagiosité.
sên	appendice.
sêndâbambî	puériculture.
sêndâbataterê	vaccinologie.
sêndâbê	cardiologie.
sêndâburuma	léprologie.
sêndâdïäbête	diabétologie.
sêndâfufû	pneumologie.
sêndâhînön	urologie.
sêndâkangba	gérontologie.
sêndâkansëre	cancérologie.
sêndâkoba	pathologie.
sêndâkobagerê	podologie.
sêndâkobahôn	rhinologie.
sêndâkobalê	ophtalmologie.
sêndâkobamê	otologie.
sêndâkobamîsahînön	néphrologie.
sêndâkobatambö	laryngologie.
sêndâkobayângâ	stomatologie.
sêndâkötäkörö	phtisiologie.
sêndâküïngö-terê	anesthésiojogie.
sêndâlämätîsi	rhumatologie.
sêndâlïndïsa	bactériologie.
sêndâlöbê	psychanalyse; psychiatrie.
sêndâmbângi	toxicologie.
sêndâmênë	hémathologie.
sêndânganga	sciences médicales.
sêndângbondâ	sexologie.
sêndângo	obstétrique.
sêndângûmênë	sérologie.
sêndâpêlambukä	traumatologie.
sêndâpopö koba	symptomatologie.
sêndâsaterê	anatomie.
sêndâsêbê	psychologie.
sêndâsënë	parasitologie.
sêndâsisa	neurologie.
sêndâsisätën	parodontologie.
sêndâsöngö-sisa	neuropathologie.
sêndâtën	odontologie.
sêndâterê	physiologie; physique.
sêndâterê-wâli	gynécologie.
sêndâtûmbe	pédiatrie.
sêndäyorö	pharmacologie.
sënë	helminthe; parasite.
sënë tî bê	douve de foie.
sênë tî mênë	trypanosome.
sënë tî yâ	ver intestinal.
sënëlitâ	tricocéphale.
sënëvi	lamblia.
sëngö-yângâ	perte d'appétit.
sêngûmênë	sérosité.
sênî	santé.
sênzönî	qualité.
sêpatâ	surdi-mutité.
sêpêrêmä	prėmaturité.
sërôme	sérum.
sërôme tî mênë	sérum sanguin.
sêsânkoba	séronégativité.
sêsaterê	morphologie.
sêwakoba	séropositivité.
sidäa	sida.
sïgïngö tî kobêla	cas.
sïgïngö-gbikï	transpiration.
simäa	plâtre.
sîngâ	mycose.
sïnüzîte	sinusite.
sïököngö-küä	pilosisme.
sïökönöngö	obésité.
sïöni-bê	rate.
sïötambûla	trouble.
siri	pou de tête.
sisa	nef.
sisagbênga	tendon.
sisamî	bulbe.
sisamû	veine.
sisätën	parodonte.
sisato	artère.
so	imiter.
sobîsi	blennorragie; chaude-pisse; gonoccocie; gonorrhée.
söngö	imitation; mal.
söngö tî bê	cardialgie.
söngö tî sisa	névralgie.
söngö-bängö-yâ	dysménorrhée.
söngö-biö	ostéalgie.
söngö-dabambî	métrite.
söngö-dondö	vaginisme; vaginite.
söngö-dûgô	pharyngo-laryngite.
söngö-dûkëngë	urėtrite.
söngö-fufû	pneumonie.
söngö-gbênga	arthralgie.
söngö-kaköbê	péricardite.
söngö-kpësisa	myélopathie.
söngö-kundü	gastralgie.
söngö-li	encéphalalgie.
söngö-lingbondâ	sciatique.
söngö-mê	otalgie.
söngö-mîkere	ténesme.
söngö-mîsahînön	néphrite.
söngö-ndâgô	pharyngite.
söngö-ngombembö	trachéite.
söngö-ngongo	spondylarthrite.
söngö-pekô	dorsalgie; lombalgie.
söngö-pëmbë	adontalgie.
söngösisa	neuropathie.
söngö-vi	entéralgie.
söngö-yâ	colique.
söngö-yâterê	courbature.
sörö	crachat.
sösö	gaz; pet; péter.
sû	prescription.
süängö tî mênë	circulation sanguine; hémorragie.
süängö-ngûhôn	rhinite.
sûku	enfler.
sukûla	aseptiser.
sükülängö	asepsie.
süküngö	bouffissure; enflure; gonflement; néoplasie; néoplasme; oedème; tumescence.
süküngö-mê	oreillon.
süküngö-pörölê	bléphorite.
süküngö-pöröyângâ	chéilite.
süküngö-yâ	ascite.
süküngö-yê	nodosité.
sûn	furoncle.
sûru	inciser; opérer.
sürüngö	chirurgie.
sürüngö	incision; intervention chirurgicale.
sürüngö-me	mammoplastie.
sürüngö-ndoro	kératotomie.
sürüngö-pëmbë tî âmôlengê	pédodontie.
sürüngö-pöröyângâ	bec de lièvre.
sürüngö-tambö	laryngectomie; laryngotomie.
tâbambî	mère d'un nourrisson.
tägä	pancréas.
tagô	aore.
tâkâfi	cellule.
tâkâsa	protozoaire.
tambö	larynx.
tângbö	mère des jumeaux.
tângo tî bängö-yâ	menstruation.
tângömbo, töngömbo	stérile.
tara wakobêla	palper.
tärängö-wakobêla	palpation.
tasïon	tension artérielle.
tâsökö	oxygène.
tëndëngbendë	conjonctivite.
teniä	ténia.
tenpäa	tympan.
terê	corps; sexe.
terêkate	flanc.
tëtänôse	tétanos.
tîa	manquer.
tîahînön	anurie; oligurie.
tîamênë	anémie; hémophiłlie.
tïängö	déficience; manque.
tïängö vitämîni	avitaminose.
tïängö-ngangü	myatonie.
tïängö-ngû	déshydratation.
tïängö-nzara	anorexie.
tiföo	typhoïde.
tîko	quinte de toux; toussoter.
tîko tî dengbe	cogueluche.
tïköngö	toussotement.
to pupu	insuffler.
töboma	pandémie.
tölambukä	ulcération; ulcère.
töligerê	gros orteii.
tonga	seringue.
tötasïon	hypertension artérielle.
tûku mênë	saigner.
tûku ngûlê	larmoyer.
tüküngö-ngo	avortement.
tüküngö-ngûlê	larmoiement.
tülängö	chétif, maigrichon.
turûngu	nombril.
vi	intestin.
vïtämîni	vitamine.
vukölê	iris de l'oeil.
vuru	exsangue; livide; pâle (être).
vurü ngû	pertes blanches.
vürüngö	pâleur.
wabängö-kpälë-yorö	allergologue.
wabäsïngö-buruma	contrôleur-lèpre.
wabiakenge-sânkobêla	porteur sain.
wabôbô	accoucheuse; infirmier accoucheur; sage-femme.
wabôbô tî ködörö	matrone.
wabörö	goitreux.
waburuma	lèpreux.
wadïäbête	diabétique.
wadrëpä	drépanoçytaire.
wafängö-ganzâ	circonciseur, exciseur.
wafufulafu	épileptique.
wagamüngö-yorö	allopathe.
wagbâdüngö	multipare.
wagbetasïon	hypotendu.
wagbötöngö	convulsionnaire.
wagïrîpe	grippé.
wagügümä	bègue.
wakä	blessé.
wakäïngö kobêla	thérapeute.
wakïföngö	loucheur.
wakïrïngö-sêterê	convalescent.
wakoba	séropositif.
wakobali	névropathe; psychopathe.
wakobêla	mafade; porteur de germes.
wakodë	praticien.
wakörökate	bronchiteux.
wakötäkörö	tuberculeux.
wakôzo-düngö	primipare.
wakpökä	sourd.
waküïngö-terê	anesthésiste.
walengbe	polydactyle.
wâlïdüngö	parturiente.
walingö	facteur.
wambângi	toxicomane.
wamüngö-bataterê	vaccinateur.
wamüngö-palü	plasmodium.
wandûndu	albinos.
wanganga	généraliste; médecin.
wanganga tî pëmbë	dentiste.
wanganga tî pöröterê	dermatologiste.
wanganga-bebe	hépatologue.
wangangaburuma	léprologue.
wanganga-gerê	pédicure.
wangangalê	oculiste.
wanganga-sêndâmê	audioprothésiste.
wangën	patient.
wängö tî nganga	avis médical.
wapalü	paludéen.
wapito	incirconcis.
wara	détecter.
wasêndâbambî	puéricultrice.
wasêndâbê	cardiologue.
wasêndâboma	épidémiologiste.
wasêndâdïäbête	diabétologue.
wasêndâfufû	pneumologue.
wasêndâhînön	urologue.
wasêndâkansëre	cancérologue.
wasêndâkoba	pathologiste.
wasêndâkobagerê	podologue.
wasêndâkobalê	ophtaimologiste; ophtalmologue.
wasêndâkobamîsahînön	néphrologue.
wasêndâkobayângâ	stomatologiste; stomatologue.
wasêndâkötäkörö	phtisiotogue.
wasêndâlämätîsi	rhumatologue.
wasêndâlïndïsa	bactériolagiste.
wasêndâlöbê	psychanalyste; psychiatre.
wasêndâmbângi	toxicologue.
wasêndâmênë	hémathologue.
wasêndângbondâ	sexologue.
wasêndângo	obstétricien.
wasêndâpêlambukä	traumatologiste; traumatologue.
wasêndâsaterê	anatomiste.
wasêndâsêbê	psychologue.
wasêndâsisa	neurologue.
wasêndâtën	odontologiste.
wasêndâterê	physiologiste.
wasêndâterê-wâlï	gynécologue.
wasêndâtûmbe	pédiatre.
wasêndâyorö	pharmacien; pharmacologue.
wasidäa	sidéen.
wasïökönöngö	obèse.
wasürüngö	chirurgien.
wâterê	température.
watîamênë	hémophile.
watötasïon	hypertendu.
wayërëtê	malnutri.
wayïngö	fou.
wazën	handicapé; infirme; paralytique.
wazibä	aveugle.
wo	faiblir.
wo	terê relaxer.
wôko	faiblir.
wököngö	affaiblissement; faible; faiblesse.
wököngö-biö	ostéomalacie.
wöngö	affaibli.
wöngö-terê	relaxation.
wüngö	quantité.
yâbêli	voûte du crâne.
yâgbegerê	voûte plantaire.
yakêrêsa	germe.
yämbätï	paume.
yângâ	bouche.
yângâdondö	vulve.
yângâdûgô	épiglotte.
yângâ-mîsa	col.
yangba	variole.
yängö-kobêla	propagation.
yâpu	soulager.
yê-pupu	aérobie.
yërëkôbe	sous-alimentation.
yërëtê	malnutrition.
yïngö	folie.
yole	hémorroïdes.
yongba	baffouillement; balbutier.
yöngbängö	balbutiement.
yongôro biögerê	péroné.
yongôro litï	médius.
yôro	introduire.
yorö	médicament; poison; remède.
yorö tî ködörö	pharmacopée.
yôro tiyöo	intuber.
yôro yorö	inoculer.
yöröngö-tiyöo	intubation.
yöröngö-yorö	inoculation.
yuru gbikï	transpirer.
yürüngö	suintement.
yürüngö-hôn	rhume de cerveau.
yürüngö-mê	otorrhée.
yürüngö-mênë	saignement.
zakara	oxyure.
zarangba	ankylose.
zegbesa	microbe.
zën	handicap; infirmité; paralyser.
zën-mbâgëko	monoplégie.
zën-mbâgëse	paraplégie.
zënngö-terê	paralysie.
zî terê	déboîter.
zîa ndê	isoler.
zîa simäa	plâtrer.
zïängï simäa	plâtrage.
zïängö-ndê	isolation.
zïängö-ngo	insémination naturelle.
zïängö-serôme	perfusion.
zïbä	cécité.
zîngo	masser; réanimer.
zïngöngö	réanimation.
zïngöngö-bê	massage cardiaque.
zïngö-terê	déboîtement.
zîri	intoxiquer.
zïrïngö	intoxication.
zolë	prunelle.
zonäa	zona.
zürüngö	somnolence.
