A-a
agîngî : abcès
äkïlösëtôme : ankylostome.
ämîbe : amibe.
ampûle : ampoule.
ängïlîli : anguiltule. .
asïäkulä : auriculaire
äsïkärîsi : ascaride; ascaris

B-b
bâa bê : ausculter
bâa pâsi : souffrir
bâa wakobêla : consulter l
babango : index.
bambî : nouveau-né
bânde : bande
bandêe : bander
bängö bê : ausculation cardiaque.
bängö wakobêla : auscultation.
bängö-ngongo : lordose; scoliose
bängö-pekô-wakobêla : suivi d'un malade
bängö-wakobêla : consultation
bängö-yâ : menstrues; règles
basa : dysenterie
bata-gbogbo : grabataire
bätängö : préservation
bataterê : vaccin

55

bê : coeur.
bebe : foie.
bela : oindre l
bêliforôto : fontanelle. Í
berîberïi : béribéri.
bi na dapïämë : interner.
biakenge : virus
biböon : bubon.
bilarazïi tî hînön : bilharzie urinaire.
bilarazïi tî vi : bilharzie intestinale.
bingö-ngo : insémination artificielle
bingö-ngû na yâ : lavement
biö : os
biöbêli : pariétal
biögô : axis; vertèbre cervical.
biökate : côte.
biököndâ : sacrum
biökongï : occiput.
biökünï : fémur
biöli : bofte crânienne; crâne.
biölikünï : rotule.
biöngbângbâ : maxillaire; mâchoire
biöngongo : rachis; vertèbre
biöpekôli : occipital.
biôke : bloc opératoire.
bôbô : placenta.
boma : endémie;, peste;
bömböngö : étreinte.

56

börö : goitre
bozöhînön : vessie
bübängö-terê : difformité
bübängö-yâ : fausse couche
bûburû : sourd-muet.
bûngbi : associer.
buruma : bacille de Hansen; lèpre
butöon : orgelet

D-d
dabambî : matrice; utérus
dädä : crampe
dadüngö : maternité
dagizamäa : laboratoire
dakängängö-kä : salle de pansements
dakängö-yorö : pharmacie
dakängö-yorö tî âwaködörö : pharmacie communautaire
dakängö-yorö tî kêtê ködörö : pharmacie villageoise.
dakängö-yorö-sânzîrî : pharmacie ge garde
dakate : torse
dakëtëngö : salle de prélèvement.
dakötäkörö : sanatorium
daküngö : salle d'attente
dambâgô : luette
danganga : clinique; infirmerie
danganga tî kötäkörö : préventorium
dangangaburuma : léproserie
dapärä : ovaire

57

dapïämë : maison de fou.
dasânzîrî : salle de garde.
dasënë : kyste.
dasürüngö : salle d'opération
daveke : syphilis; vérole.
dayämbängö : salle d'accueil.
dayorö : officine
dênge : dengue
dëngö : ablation
dëngö : morsure.
dëngö : vomissure.
dëngö-dapärä : ovariectomie.
dëngö-fufû : pneumectomie.
dëngö-mbâgëkundü : gastrectomie.
dëngö-me : mammectomie
dëngö-mênë : hématémèse.
dëngö-mîsahînön : néphrectomie.
dëngösên : appendicectomie.
dëngö-terê : mutilation.
dïäbête : diabète.
dïmïnïngö : atrophie E
dïrïngängö : cachexie.
dïrïngö : diminution.
dö dê : frissonner
dokotöro : docteur.
dondö : vagin.
döngö : crise
döngö : trémulation

58

döngö-dê : frisson
drëpä : drépanocytose
dü : accoucher
dû : cavite; méat.
dû tî më : condui auditif
dudu : algie; douleur, malaise S
dudugbeyâ : pubalgie
dudukëngë : priapisme. .
dudumî : myalgie
duduvi : entérocolite
duduwâ : inflammation.
dûga : contusion o
dûhînön : urètre.
dûhôn : fosse nasale; narine.
dûkëngë : orifice préputial
dûlê : orbite de oeil
dûlêgë tî gbeyâ : canal inguinal .
dûlêgë-ngonzo : canal cystique
dûngbângbâ : fossette
düngö : parturition
düngö pêrêmä : naissance prématurée ;
düngö, düngö-môlengê : accouchement
dûnyerë : orifice anal :
dûpöröterê : pore.
dûtambö : glotte.
dûturûngu : ombilic.
ëpätîte : hépatite. y

59

F-f
fâa ganzâ (kôlï) : circoncire l
fâa ganzâ (wâlï) : exciser
fâa zegbesa : désinfecter.
fâmbö : anoxie.
fâmbö-mênë : anoxémie
fängbïngö-pärä : ovulation. p
fängö-biö : fracture.
fängö-ganzâ : circoncision.
fängö-kâmbapärä : vasectomie.
fängö-lëndâ : clitoridectomie.
fängä-mabôko, fängö-gerê : moignon
fängö-mbö : asphyxle; étouffement.
fängö-ngungu : démoustication
fängö-sënë : déparasitage.
fatikêe : fatiguer.
fêvere : hypertermie.
fi : puíivériser
fi körö : moucher (se -)
fibörôme : fibrome
filëre : filaire
fïngö : pulvérisation.
fïngö-pupu : expiration.
finî tî ke-pupu : anaérobiose
finî tî yê-pupu : aérobiose
finon : sténose.
fïnöngö : occlusion
fïon-yângâ : haleine

60

forôto : nourrisson.
fû kä : suturer.
fufû : poumon.
füngö-kä : suture.
fünngö : putréfaction ya
fürüsä : bave.

G-g
gä ngangü : aggraver p O0TOn
gä sänzö : suppurer o
gabä : attaque E
gamênë : rhésus -
gamüngö-yorö : allopathie " =y
gamvulê : presbytie
gangiliöon : ganglion i
gängö-ngûme : montée laiteuse
gängö-ngûyângâ : salivation.
gängö-sänzö : suppuration
ganzâ : circoncis; excision
ganzâ (wâlï) : excisée
gâze : bande de gaze
gbâbiöterê : squelette
gbâködörö tî sênî : région sanitaire
gbâmüngö-yorö : soins intensifs
gbängbängö : aggravation; gravité
gbângo : muitigeste
gbängö-terê : relation sexuelle
gbânzi na danganga : hospitaliser

61
========
gbänzïngö na danganga : hospitalisation
gbâpopö : syndrome l
gbë : ligaturer.
gbe tîyâ : pubis
gbegerê : plante du pied.
gbeküäli : cuir chevelu,
gbelê : pommette.
gbênga : articulation; articuler.
gbêngângbi : articuler (s'-)
gbëngö : ligature
gbepörö : sous-cutané; épiderme.
gbepörömê : lobe de l'oreille.
gbepöröterê : derme l
gbetäsïon, ipo : hypotension artėrielle.
gbeterêkate : hanche
gbeti : aisselle
gbeyâ : abdomen; bas-ventre
gbeyângâ : menton.
gbïënngë : sénescence.
gbiki : sueur
gbôgbôlinda : hébéphrénie; rage
gbôkolobô : éléphantiasis des bourses.
gbôpâla : migraine
gbôto : convulser;, ponctionner
gbôto na hôn : inhaler
gbötöngö : avulsion, convulsion; ponction
gbötöngö na hôn : inhalation
gbötöngö-mênë : prise de sang; saignée

62

gbötöngö-ngû : paracentèse g
gbötöngö-pupu : inspiration.
gbütängbü : annulaire
gerê : membre inférieur; pied
gind : dépister.
gingö-ndâ : dépistage
gingö-ndâkobêla : diagnostic
giöngö-bê : agonie; râle.
girpe : grippe; influenza
gizamäa : examen
gizamäa tî mênë : analyse de sang.
gizamäa tî nganga : analyse médicale.
gizamäa tîsörö : goutte salivaire.
gô : cou; gorge.
gönngë : bourdonnement.
goro : palpiter
göröngö-bê : palpitation
gügü : champignon.
gügümä : bégaiement
guguma : bėgayer.
gümbängö : puberté
gündâ-pëmbë : gencive
gûte : goutte

H - h.
A E SA aae encen iasa EEEE
hâko yorö : médicament essentiel
hâkokomä : lipothymie
hän : relever de maladie

63

hänngö-terê : santé
hinikängö : massage.
hïiningöë : badigeonnage; onction
hînön : urine; urée
hôn : nez.
hôngakôbe : diète
hônga-kôbe : régime alimentaire.
hônti : poignet
hünzïngö-ngangü : péremption

I-i
ikitëre : ictère

K-k
kä : blessure
kä : plaie.
kä tî dapärä : salpingite.
kä tî kpôkpôrô : prurit.
kä tî lêkorobô : orchite.
kä tî pôpôrô : prurigo
kätîwâ : brûlure.
kä tî yângâ : stomatite.
kabanöäo : asile d'aliénés
kâi : calmer
kâi : interrompre un traitement
kâi kobêla : soigner; traiter
ki ngangü : atténuer

64

käïngö-bängö-yâ : ménopause
käïngö-kobagerê : pédicurie
käïngö-kobapëmbë : dentisterie
käïřngö-kobêla : thérapeutique; thérapie; traitement
käřngö-kobêla wanî : autotraitement
käïngö-mbö : apnée
kakä : membrane
kaköbê : péricarde.
käkundü : gastrite.
kalê : tempe
kalor : calorie
kâmba tî turûngu : cordon ombilical.
kâmbahînön : uretère.
kâmbakä : point de suture
kâmbamênë : vaisseau
kändâyângâ : perlèche.
kando : pédiculose
kânga : panser
kânga : lêgë oblitérer
kängăängö : atrésie; bandage; pansement
kängängö-lêgë : biocage; oblitération; obstruction
kânga-purû : constipation
kâêngbi kobêla : propager
kansëre : cancer
känzënë : griffure l
kar : carie
käsisa : névrite
kätärâte : cataracte.

65

kate : cage thoracique; poitrine; thorax.
këngë : pénis; verge
këngö-yorö : allergie
ke-pupu : anaérobie. ;
kêre : angine. i
keresa : globule i
kêtê : mince i
kêtê mêdondö : petites lèvres.
kêtêbiö : osselet
kêtêdanganga : dispensaire
kêtêdûgô : trachée
kêtêkä : excoriation; écorchure; égratignure; éraflure. i
kêtêli : microcéphale.
këtëngö : prélèvement.
kêtêsisa : nervure
kêtêsisamû : veinule
kêtêyangba : varicelie
kifo : loucher.
kiföngö : loucherie.
kînda : cadavre.
kîri goangba : recrudescence.
kiring bängö-yâ : retour de couches.
kiringö-kobêla : rechute.
kiringö-sêterê : convalescence
kiröngö-sêndâsaterê : anatomopathologie
koä : tique.
kobabê : cardiopathie
kobabebe : cirrhose.

66

kobabiakenge : virose
kobabiö : ostéite; ostéopathie
kobabomalê : glaucome
kobafufû : broncho-pneumonie; pneumopathie
kobagûênngû : potomanie
kobagündâ-pëmbë : gingivite
kobahîngö : albuminurie
kobahînön : urémie.
kobakâmbamênë : fymphangite.
kobakönöngöä-bê : cardiomégalie
kobakötädûgô : œsophagite
kobakötävi : colopathie
kobakpëli : encéphalopathie
kobalê : amétropie, ophtalmie.
kobali : encéphalite;, nėvropathie; psychopathie.
kobamânga : tabagisme
kobamê : otite
kobamênë : piroplasmose
kobamî : myosite. ;
kobamozambë : trypanosomiase
kobandâhôn : rhinopharyngite.
kobandoro : kérațtose
kobangongo : lumbago; rachialgie
kobangurû : ostéochondrite
kobanyöngû : polydipsie g ,
kobanzara-ngû : anadipsie
kobanzënë : onyxis
kobapörö-terê : allergide

67

kobapöröterê : dermatite; dermatose; dermite
koba-pöröterê : favus
kobasahînön : néphropathie.
kobasatën : puipite.
kobasënë : helminthiase; parasitose; toxoplasmose.
kobasënëvi : lambliase
kobasênzënngö : surmenage.
kobasisa : tendinite.
kobasisätën : parodontose.
kobatägä : pancréatite
kobatambö : laryngite.
kobatombôka : maladie mentale
kobavitämîni : scorbut.
kobawöngö : polypnée.
kobayângâ : candidose
kobêlła : affection, maladie .
kobêla fî äkilösëtme : ankylostomiase.
kebêla tî ämîfbe : amibiase
kobêla tî ängïlîli : anguillulose.
kobêla tî bilarazii : bitharziose; schistomiase
kobêła tî biöli : acrocéphalie.
kobêla tî fufû : fluxion de poitrine
kobêla tî gbênga : arthrite
kobêla {fî mafüta : adipose
kobêla tî makâko : épilepsie.
kobêla tîwâ : fièvre
kobela tî zakara : oxyurose
kodë : méthode.

68

kolêe : coaguler
kölëngö : coagulation
kölëngö mênë : caillot.
koleräa : choléra
komä : apoplexie; coma.
köndôme : condom
kongf : nuque
könöngö : grosseur
könöngö yâ tî kötävi : mégacôlon,
könöngö-nganzï : bronchectasie
könöngö-ngümbä : splénomégalie
könöngö-yâmîsa : ectasie.
koro : tousser.
körö : toux.
korobô : bourse
körökate : bronchite
körömëngë : hernie
kötä boma : grandes endémies.,
kötä mêdondö : grandes lèvres
kötädûgô : oesophage.
kötä-ger& : éléphantiasis
kötäkörö : bacille de Koch; phtisie; tuberculose
kötäli : macrocéphale
kötämbeto : psychose
kötä-pëmbë : molaire.
kötäpëmbë : prémolaire
kötätonga : trocart
kötävi : caecum; côlon; gros intestin

69

kötimênë : rhésus +
koto : tumeur.
kôzo kobêla : primo-infection
kôzo müngö-yorö : soins primaires.
kôzo ngo : primigeste
kôzo purû tî forôto : méconium l
kpälë tî düngöë : dystocie
kpälë tî särängö-hînön : dysurie
kpätë tî wöngö : dyspnée
kpalüzôle : rubéole i
kpâti : omoplate.
kpäyämä : prolifération
kpayama : proliférer
kpë kobêĉla : prévenir
kpëbiëö : moelle
kpekpë : babilage
kpëli : cerveau; encéphale
kpëngbängö : raideur.
kpëngbängö-mî : sclérose
kpëngö-kobêla : prévention
kpëngö-terê : prophylaxie
kpëpëmbë : tartre
kpësisa : moelle épinière
kpïngë : mourant
kpo : injecter
kpökä : surdité
kpongbö : énurésie
kpöngö : injection

70

kpöngö : piqûre.
kpöngö-kate : point de côté.
kporo : fermenter
kpûzegbesa : bacille.
kûâ : décès; mort
küä : pilosité
küähôn : vibrisse.
kûâlê : cil.
küäli : cheveu.
küändolê : sourcil.
küängbângbâ : favoris. i
küänyö : moustache.
küäterê : poil.
küäyângâ : barbe.
kubû tf nganga : cabinet médical.
kûi : décéder.
kûi : mourir.
kûi : terê anesthésier.
küïngö-hôn : anosmie.
küïngö-këngë : impuissance sexuelle.
küïngö-ndöyingö : syncope.
küïngö-terê : anesthésie.
kundü : estomac.
kûngûlûûbä : bossu.
küní : cuisse.
kûtu : bosse; écchymose.
kûtubiö : malléole.

71

kûtugerê : cheville.

L-l
labatäni : hôpital.
lämätîsi : rhumatisme.
lambu : tissu.
lambukä : lésion.
lê : faciès; figure; oeil; visage.
lebe : couche.
lêgë : t-müngëö mode de contamination.
lêgëmê : trompe d'Eustache.
lêgëpärä : trompe de Fallope.
têkorobô : testicule.
lele : dartre.
lëndâ : clitoris.
lengbe : polydactylie.
libê : plexus sotłaire.
lideku : épistaxis.
ligerê : ortei!.
likëngë : gland.
likünï : genou.
lime : mamelon; téton.
limëngä : apex.
lindisa : bactérie.
lingö-dapiämë : internement.
fingö-sënë : infestation.
lingö-zegbesa : infection.

72

lipë tî sênî : repos (sanitaire).
litt : doigt.
iobokakë : muqueuse. :
löndöngö : érection.
döndöngö-bëê : nausée.
tüzôle : rougeole.

M -m.
mä söngö : ressentir un mal.
mabôko : avant-bras; bras; main; membre supérieur.
mabôko-na-gerê : membre.
mäingö tî kobêla : stade.
mäïngö tî mabôko-na-gerê : développement moteur,
mäïngö-kobêla : septicémie.
mäïngö-saterê : développement physique.
mamâ : mère.
mana : miction.
mängëngö : carence.
mängëngö-lêkorobô : anorectite,
mängö-ndo : audition.
mbarafanyî : teigne.
mbëtiyorö : indication médicale; ordonnance; prescription médicale.
mboatën, kari : carie dentaire.
mbômbôli : calvitie.
mboro : acné; bouton; pustule.
mbumalê : globe oculaire.

73

mbünë : boiterie; claudication; foulure.
me : mamelle; sein.
më ngo : tomber enceinte.
mê-dondö : nymphes.
mênë : sang.
mënëzite : méningite.
mëngä : langue.
mî : muscle; substance.
mîkere : sphincter,
mîsa : organe.
mîsahînön : rein.
mîterê : musculature.
moọkërëlö : hémorragie nasale.
molölömë : insommie.
möngöli : cervelet.
mü : cicatriser.
mû : prélever.
mû : bataterê vacciner.
mû kobêla : contaminer, contracter une maladie; transmettre une maladje.
mû mênë : transfuser.
mû ndo : infester.
mû ng : hydrater; rehydrater.,
mû siöyorö : empoisonner.
mû tasïion : prendre le pouls.
mû yorö : administrer.
mû zegbesa : infecter.
müngö kobla : transmission de maladie.

74

müngö-bataterê : vaccination.
müngö-kobêla : contagion; contamination, contraction d'une maladie. g
müngö-mabôko tî wanganga : assistance médicale. l
müngö-mênë : transfusion.
müngö-ngûû : rehydratation.
müngö-stiöyorö : empoisonnement.
müngö-tâsökö : oxygénothérapie.
müngö-vitämîni : vitaminothérapie.
müngö-yorö : administration de médicament; cure; soins.
müngö-yorö : wanî automédication.
mvulê : myopie.

N-n.
nï purû : déféquer.
ningö : excrétion.
nïingö-purû : défécation; déjection.
nökpöngö : repli cutané.
nökpöngö-terê : pli de la peau,
nörö : anomalie; déformation; malformation; tare.
ndâ : rectum. l
ndâgerê : talon.
ndâgô : pharynx; voile du patais.
ndâkobêla : étíologie.
ndângängä : mollet.
ndârâ : tension.
ndârâkpû : fibre.

75

ndarä-na-terê : psychomoteur. j
ndënë : entorse; luxation.
ndîbîlfsisa : capillaire.
ndöbê : sternum; épigastre.
ndöbêli : vertex.
ndölê : front.
ndöngâ : palais de la bouche.
ndonganga : centre de santé. i ;
ndonganga : poste de santé. |
ndörö : cicatrice. i
ndoro : kératite. i
ndoto : pomme d'Adam. i
ndowâ : bourbouille. i
ndûrûkpâ : nanisme.
nganga : guérisseur; médecine; médecine préventive.
ngängä : jambe. f
nganga tî ködörö : médecine traditionnelte; tradi-practiçien.
nganga tî söngö-zo : médecine curative. ,
ngangasüä : acuponcture.
ngangasüä : acupuncture.
nganzí : bronche.
ngâsi : éternuement; éternuer.
ngbädä : pou de pubis.
ngbâlo : céphalée.
ngbângbâ : joue.
ngbö tî lê : onchocercose.
ngbondâ : fesse.
ngbongaterëê : tronc.

76

ngbongbö : hernie ombilicale.
ngböngô : tibia.
ngbö-otâ : triplé.
ngbotoro : cor; durillon.
nge : amaigri; atrophier; dépérir; maigrir.
ngëngë : amaigrissement.
ngëngöë : maigre; maigreur.
ngënzë : impétigo.
ngiba : lèpre tuberculoïde.
ngîgerê : arche du pied.
ngîpëmbë : arcade dentaire.
ngira : tabou.
ngri : ronfler.
ngirngö : ronflement.
ngombembö : trachée-artère.
ngöëmbo : stérilité.
ngöngnö-lindïisa : leptospire.
ngongo : bassin; colonne vertébrale; râble.
ngonzo : bile; fiel; venin.
ngöti : coude.
ngûhôn : morve.
ngûlê : larme.
ngûmbâ : hypertrophie de la rate.
ngûmênë : plasma sanguin.
ngûmîsa : suc.
ngumu : herpès.
ngungu : anophèle.
ngunuterê : énergie physique.

77

ngunuwâ : énergie calorifique. l
ngurûngurû : cartilage.
ngusü : larve; puce.
ngûterê-kôli : sperme. |
ngûyângâ : salive i
ngûyorö : solution. i
nguzü : chique.
nyamame : mammifère.
nyerë : anus.
nyïkpíingöë : mor-né.
nyö me : téter.
nyöngö-mbângi : toxicomanie.
nyöngö-me : téļtée
nzara : faim.
nzekete : prélever.
nzënë : ongle.
nzënngö : asthénie; dégénérescence.
nzefi : vertige.
nzombö : pellicule des cheveux. ,
nzorôko tî terê : pigment.

O-o
opërëe : opéré.
ôro : prélever (organe).
ôro korobô : émasculer
öröngö-korobô : émasculation.

78

P-p
palâta : plaque.
palü : malaria; paludisme.
pâmboti : épaule.
panar : panaris.
pängä : asthme.
pâpà : poche.
pärä : oeuf.
pärä tî môlengê (wâ) : ovule.
päräsënë : oeuf de ver.
päräti : apophyse.
pâsi : souffrance.
pêdûga : meurtrissure.
pekô : dos.
pêlambukä : trauma; traumatisme.
pëmbë : dent.
pend gizamä : résultat d'analyse.
pëndïsîte : appendicite.
pëngö-bê : bradycardie.
pêrêmä : prématuré.
pete : presser.,
piämë : démence; folie furieuse.
pikängö-bê : pouls; pulsation.
pito : prépuce.
pëökö : kwashiorkor.
polio : poliomyélite.
pönzö : particule.

79

popö : koba symptôme.
popëö kobêlła : signe pathologique.
pöpöngbondâ : sillon fessier.
pôpôrô : chancre mou; pian.
pörö : peau; préservatif.
poroko : glabre; imberbe.
pörö-lêkorobô : scrotum.
pörömê : pavillon de l'oreille.
pöröyângâ : lèvre.
purû : déchet; excréments; selles.

R-r
radið : radiographie.
radio tîme : mammographie.
reä : réanimation (salle de ~).

S-s
sa körö : expectorer.
sâa na gïigî? : excréter.
sängö-körö : expectoration.
sängö-yâ : ménorragie.
sangûterê-kôli : spermatozoïde.
sânkoba : séronégatif.
sänzëngö-mênë : exsanguino-transfusion.
sânzîr : anticorps.
sänzö : pus.

80

sara : démanger; picoter.
särä : gale.
sâra : gizamäa analyser.
sâra hînön : uriner.
sâra kä : ulcérer.
särängö : démangeaison; fourmillement.
särängö : picotement.
särängö-yê : attitude.
sasa : diarrhée; purge; purger.
sasa-mo-dë : diarrhée avec vomissements,
savâa : guérir; recouvrer ia santé; rétablir (se -).
sävängö : guérison.
sêkêtê : bénignité.
sêku : hoquet
sêmbângi : toxicité.
sêmîsa : corps humain; organisme.
sêmüngö-kobêla : contagiosité.
sên : appendice.
sêndâbamb?î : puériculture.
sêndâbataterë : vaccinologie.
sêndâbê : cardiologie.
sêndâburuma : léprologie.
sêndâdiäbête : diabétologie.
sêndâfufû : pneumologie.
sêndâhînön : urologie.
sêndâkangba : gérontologie.
sêndâkansëre : cancérologie.
sêndâkoba : pathologie.

81

sêndâkobagerê : podologie.
sêndâkobahôn : rhinologie.
sêndâkobalê : ophtalmologie.
sêndâkobamê : otologie. l
sêndâkobamîsahinön : néphrologie.
sêndâkobatambö : laryngologie.
sêndâkobayângâ : stomatologie.
sêndâkötäkörö : phtisiologie.
sêndâküïngö-terê : anesthésiojogie.
sêndâlämätîsi : rhumatologie.
sêndâlľindisa : bactériologie.
sêndâlöbê : psychanalyse; psychiatrie.
sêndâmbângi : toxicologie.
sêndâmênë : hémathologie.
sêndânganga : sciences médicales.
sêndângbondâ : sexologie.
sêndângo : obstétrique.
sêndângûmênë : sérologie.
sêndâpêlambukä : traumatologie.
sêndâpopö koba : symptomatologie.
sêndâsaterê : anatomie,
sêndâsêbê : psychologie.
sêndâsënë : parasitologie.
sêndâsisa : neurologie.
sêndâsisätën : parodontologie.
sêndâsöngö-sisa : neuropathologie.
sêndâtën : odontologie.
sêndâterê : physiologie; physique.

82

sêndâterê-wâli : gynécologie.
sêndâtûmbe : pédiatrie.
sêndäyorö : pharmacologie.
sënë : helminthe; parasite.
sënë tîbê : douve de foie.
sênë fî mênë : trypanosome.
sënë fî yâ : ver intestinal.
sënëlitâ : tricocéphale.
sënëvi : lamblia.
sëngö-yângâ : perte d'appétit.
sêngûmênë : sérosité.
sênî : santé.
sênzönî : qualité.
sêpatâê : surdi-mutité.
sêpêrêmä : prėmaturité.
sërôme : sérum.
sërôme t mênë : sérum sanguin.
sêsânkoba : séronégativité.
sêsaterê : morphologie.
sêwakoba : séropositivité. E
sidäa : sida.
sïigingö tî kobêla : cas.
sïgïngö-gbiký : transpiration.
simäa : plâtre.
sîngâ : mycose.
sïnüzíte : sinusite.
siököngö-küä : pilosisme.
siökönöngö : obésité.

83

siöni-bê : rate.
siötambûla : trouble.
siri : pou de tête.
sisa : nef.
sisagbênga : tendon.
sisamî : bulbe.
sisamû : veine.
sisätën : parodonte.
sisato : artère.
so : imiter.
sobîsi : blennorragie; chaude-pisse; gonoccocie; gonorrhée.
söngö : imitation; mal.
söngö třbëê : cardialgie.
söngö tî sisa : névralgie.
söngö-bängö-yâ : dysménorrhée.
söngö-biö : ostéalgie.
söngö-dabambî : métrite.
söngö-dondö : vaginisme; vaginite. ,
söngö-dûgô : pharyngo-laryngite.
söngö-dûkëngë : urėtrite.
söngö-fufû : pneumonie.
söngö-gbênga : arthralgie.
söngö-kaköbê : péricardite.
söngö-kpësisa : myélopathie.
söngö-kundü : gastralgie.
söngö-li : encéphalalgie.
söngö-lingbondâ : sciatique.
söngö-mê : otalgie.

84

söngö-mîkere : ténesme.
söngö-mîsahînön : néphrite.
söngö-ndâgô : pharyngite.
söngö-ngombembö : trachéite.
söëngö-ngongo : spondylarthrite.
söngö-pekô : dorsalgie; lombalgie.
söngö-pëmbë : adontalgie.
söngösisa : neuropathie.
söngö-vi : entéralgie.
söngö-yâ : colique.
söngö-yâterê : courbature.
sörö : crachat.
sösö : gaz; pet; péter.
sû : prescription.
süängö tt mênë : circulation sanguine; hémorragie.
süängö-ngûhôn : rhinite.
sûku : enfler.
sukûűla : aseptiser.
sükülängö : asepsie. g
süküngö : bouffissure; enflure; gonflement; néoplasie; néoplasme; oedème; tumescence.
süküngö-mê :  oreillon.
süküngö-pörölê : bléphorite.
süküngö-pöröyâng : chéilite.
süküngö-yâ : ascite.
süküngö-yê : nodosité.
sûn : furoncle.
sûru : inciser; opérer.

85

sürüngö : chirurgie.
sürüngö : incision; intervention chirurgicale.
sürüngö-me : mammoplastie.
sürüngö-ndoro : kératotomie.
sürüngö-pëmbë tî âmôlengê : pédodontie.
sürüngö-pöröyângâ : bec de lièvre.
sürüngö-tambö : laryngectomie; laryngotomie.

T-t
tâbambî : mère d'un nourrisson.
tägä : pancréas.
tagô : aore.
tkâfi : cellule.
tâkâsa : protozoaire.
tambö : larynx.
tângbö : mère des jumeaux.
tângo tî bängö-yâ : menstruation.
tângömbo, töngömbo : stérile.
tara wakobêla : palper.
tärängö-wakobêla : paipation.
tasïon : tension artérielle.
tâsökö : oxygène.
tëndëngbendë : conjonctivite.
teniä : ténia.
tenpäa : tympan.
terê : corps; sexe.
terêkate : flanc.

86

tëtänôse : tétanos.
ta : manquer.
tîahînön : anurie; oligurie.
tamênë : anémie; hémophiłlie.
tiängö : déficience; manque.
tiängö : vitämîni avitaminose.
tängö-ngangü : myatonie.
tiängö-ngû : déshydratation.
tiängö-nzara : anorexie.
tiföo : typhoïde.
tîko : quinte de toux; toussoter.
tîko tî dengbe : cogueluche.
tiköngö : toussotement.
to pupu :  insuffler.
töboma : pandémie.
tölambukä : ulcération; ulcère.
töligerê : gros orteii.
tonga : seringue.
tötasřon : hypertension artérielle.
tûku mênë : saigner.
tûku ngûlê : larmoyer.
tüküngö-ngo : avortement.
tüküngö-ngûlê : larmoiement.
tülängö : chétif, maigrichon.
turûngu : nombril.

87

V-v
vi : intestin.
vitämîni : vitamine. i
vukölë : iris de l'oeil, i
vuru : exsangue; livide; pâle (être). g
vurü ngû : pertes blanches. ,
vürüngö : pâleur. l

W-w
wabängö-kpälë-yorö : allergologue.
wabäsingö-buruma : contrôleur-lèpre. |
wabiakenge-sânkobêla : porteur sain.
wabôbô : accoucheuse; infirmier accoucheur; sage-femme.
wabôbô tî ködörö : matrone.
wabörö : goitreux.
waburuma : lèpreux.
wadiäbête : diabétique.
wadrëpä : drépanoçytaire.
wafängö-ganzâ : circonciseur, exciseur.
wafufulafu : épileptique.
wagamüngö-yorö : allopathe.
wagbâdüngë : multipare.
wagbetasion : hypotendu.
wagbötöngë : convulsionnaire.
wagïrîpe : grippé.
wagügümä : bègue.

88

wakä : blessé.
wakäïngä kobêła : thérapeute.
wakiföngöë : loucheur.
wakiringö-sêterê : convalescent.
wakoba : séropositif.
wakobali : névropathe; psychopathe.
wakobêla : mafade; porteur de germes.
wakodë : praticien.
wakörökate : bronchiteux.
wakötäkörö : tuberculeux.
wakôzo-düngö : primipare.
wakpökä : sourd.
waküïngö-terê : anesthésiste.
walengbe : polydactyle.
wâlidüngë : parturiente.
walingë : facteur.
wambângi : toxicomane.
wamüngö-bataterê : vaccinateur.
wamüngö-palü : plasmodium.
wandûndu : albinos.
wanganga : généraliste; médecin.
wanganga tî pëmbë : dentiste.
wanganga tî pöröterê : dermatologiste.
wanganga-bebe : hépatologue.
wangangaburuma : léprologue.
wanganga-gerê : pédicure.
wangangalê : oculiste.
wanganga-sêndâmê : audioprothésiste.

89

wangën : patient.
wängö tî nganga : avis médical.
wapalùü : paludéen.
wapito : incirconcis.
wara : détecter.
wasêndâbambî : puéricultrice.
wasêndâbê : cardiologue.
wasêndâboma : épidémiologiste.
wasêndâdiäbête : diabétologue.
wasêndâfufû : pneumologue.
wasêndâhînöën : urologue.
wasêndâkansëre : cancérologue.
wasêndâkoba : pathologiste.
wasêndâkobagerê : podologue.
wasêndâkobalê : ophtaimologiste; ophtalmologue.
wasêndâkobamisahînön : néphrologue.
wasêndâkobayângâ : stomatologiste; stomatologue.
wasêndâkötäkörö : phtisiotogue.
wasêndâlämätîsi : rhumatologue.
wasêndâfindisa : bactériolagiste. ,
wasêndâlöbê : psychanalyste; psychiatre.
wasêndâmbângi : toxicologue.
wasêndâmênë : hémathologue.
wasêndângbondâ : sexologue.
wasêndângo : obstétricien.
wasêndâpêlambukä : traumatologiste; traumatologue.
wasêndâsaterê : anatomiste.
wasêndâsêbê : psychologue.

90

wasêndâsisa : neurologue.
wasêndâtën : odontologiste.
wasêndâterê : physiologiste.
wasêndâterê-wâli : gynécologue.
wasêndâtûmbe : pédiatre.
wasêndâyorö : pharmacien; pharmacologue.
wasidäa : sidéen.
wasïiökönöngö : obèse.
wasürüngö : chirurgien.
wâterê : température.
watîamênë : hémophile.
watötasion : hypertendu.
wayërëtê : malnutri.
wayingô : fou. l
wazën : handicapé; infirme; paralytique.
wazibä : aveugle.
wọ : faiblir.
wọ : terê relaxer.
wôko : faiblir.
wököngö : affaiblissement; faible; faiblesse.
wököngö-biö : ostéomalacie.
wöngö : affaibli.
wöngö-terê : relaxation.
wüngö : quantité.

91

Y-y
yâbêli : voûte du crâne.
yâgbegerê : voûte plantaire.
yakêrêsa : germe.
yämbäti : paume.
yângâ : bouche.
yângâdondö : vulve.
yângâdûgô : épiglotte.
yângâ-mfsa : col
yangba : variole.
yängö-kobêla : propagation.
yâpu : soulager.
yê-pupu : aérobie.
yërëkôbe : sous-alimentation.
yërëtê : malnutrition.
ying : folie.
yale : hémorroïdes.
yongba : baffouillement; balbutier.
yöngbängö : balbutiement.
yongôro biögerê : péroné.
yongôro : liti médius.
yôro : introduire.
yorö : médicament; poison; remède.
yorö t? ködörö : pharmacopée.
yôro tiyöo : intuber.
yôro yorö : inoculer.
yöröngöüä-tiyðğo : intubation.

92

yöröngö-yorö : inoculation.
yuru gbikť : transpirer.
yürüngö : suintement.
yürüngö-hôn : rhume de cerveau.
yürüngö-mê : otorrhée.
yürüngö-mênë : saignement.

Z-z
zakarąa : oOxyure.
zarangba : ankylose.
zegbesa : microbe.
zën : handicap; infirmité; paralyser.
zën-mbâgëko : monoplégie.
zën-mbâgëse : paraplégie.
zënngö-terê : paralysie.
zîiterê : débofîter.
zîandê : isoler.
zîasimäa : plâtrer.
ziängľisimäa : plâtrage.
zïiängö-ndê : isolation.
ziängö-ngo : insémination naturelle.
ziängö-serôme : perfusion.
zïíbä : cécité.
zîingo : masser; réanimer.
zingöngö : réanimation.
zingöngö-bê : massage cardiaque.
zinņgö-terê : déboftement.

93

zîri : intoxiquer.
ziringö : intoxication.
zolë : prunelle.
zonäa : zona.
zürüngö : somnolence.

94
