Afrîka	Noun
Amerîka	Noun
Bêafrîka	Noun
Nzapä	Noun
Orion	Noun
Pakara	Noun
Pleyade	Noun
Pötö	Noun
Yapakara	Noun
Yingö-Gbïä	Noun
Yingö-Vulü	Noun
Zâbolo	Noun
Zâmani	Noun
ba	Verb
baba	Noun
babâ	Noun
babâ-kêtê	Noun
babâ-kötä	Noun
badâ	Noun
bakarî	Noun
bala	Verb
balabâla	Noun
balaka	Noun
balambo	Noun
balangëti	Noun
bale	Noun
balë-	prenom
balëe	Noun
balëgümbâyä	Numeral
balëmbrâmbrâ	Numeral
balëmiombe	Numeral
balëokü	Numeral
balëomenë	Numeral
balëosïö	Numeral
balëotâ	Numeral
balëôko	Numeral
balëûse	Numeral
bambü	Noun
baminga	Noun
banga	Noun
baobä	Noun
bara	Verb
baramïi	Noun
baraô	Noun
barâsi	Noun
basënzi	Noun Adjective
bata	Verb
batakûngbâ	Noun
batizêe	Verb
batême	Noun
bazângele	Noun
be	Verb
bele	Verb
belü	Noun
bembe	Verb
benda	Noun
bendêre	Noun
bengbä	Adjective
bere	Verb
bi	Verb
bibê	Noun
bima	Verb
bindi	Noun
birä	Noun
birîki	Noun
biröo	Noun
biö	Noun
bobo	Noun
bolingo	Noun
boma	Noun
bongö	Noun
bozobozo	Noun
bozö	Noun
buba	Verb Adjective
bulëe	Noun
buruma	Noun
burü	Noun
butuma	Adverb
butöon	Noun
buzïi	Noun
buä	Noun
bâ	Noun
bâa	Verb
bâa-yê	Noun
bâan	Noun
bâbâ	Noun
bâda	Noun
bâgara	Noun
bâge	Noun
bâlâwâ	Noun
bânde	Noun
bânge	Noun
bângi	Noun
bä	Noun
bäbolo	Noun
bäkongö	Noun
bäkoyä	Noun
bäkpä	Noun
bämarä	Noun
bängâ	Noun
bängö-li	Noun
bärä	Noun
bäränzä	Noun
bätängö-nyama	Noun
bê	Noun
bêbï	Noun
bêkombïte	Noun
bêkü	Noun
bêlimbô	Adjective
bênyämä	Noun
bêôko	Noun
bëkpä	Noun
bëngo-lê	Noun
bëngë	Noun
bëngö	Noun
bëngö-lê	Noun
bîakü	Adverb
bîanî	Adverb
bîlawü	Noun
bîlîbili	Noun
bîrï	Noun
bîrö	Noun
bîâ	Noun
bï	Noun
bïkua	Noun
bïngö	Noun
bôndo	Verb
bôngbi	Verb Noun
bôon	Noun
bôrö	Noun
bôï	Noun
bö	Verb
böndö	Noun
bûburû	Noun Adjective
bûku	Noun
bûngbi	Verb Noun
bûngu	Noun
bübä	Noun
büzë	Noun
chêze	Noun
commencé
da	Existential marker
da-fononon	Noun
da-kûku	Noun
da-sînga	Noun
dabê	Verb
dabüzë	Noun
dalembë	Noun
dalängö	Noun
dalîmo	Noun
dambâ	Noun
dambëtï	Noun
danganga	Noun
dangâlingâ	Noun
daräa	Noun
dasêndâgî	Noun
daveke	Noun
dawä	Noun
dawän	Noun
dazu	Noun
daä	Existential marker
de	Verb
dedë	Adjective
deku	Noun
dema	Verb
demerdëe	Verb
dengbe	Noun
derê	Noun
diamäa	Noun
didi	Noun
dime	Noun
diminî	Verb
dindôn	Noun
do	Verb
dola	Noun
doli	Noun
dondö	Noun
dongi	Noun
dongô	Noun Adjective
doro	Verb
doroko	Verb
du	Verb
dukâni	Noun
dulëe	Noun
duma	Noun
dutëe	Noun
dutï	Verb Noun
dâlê	Noun
dädä	Noun
dê	Noun
dênge	Verb
dë	Verb
dëbä	Verb
dëkîte	Verb
dëköngö	Verb Noun
dëngö	Noun
dîko	Verb
dîngi	Verb
dîngo	Noun
dîâkere	Noun
dï	Verb
dïdïrï	Noun
dïköngö-mbëtï	Noun
dö	Verb
dödô	Verb
dödö	Noun
dödörö	Noun
dögozo	Noun
dörö	Verb
dû	Noun
dû-ngû	Noun
dûche	Noun
dûnîa	Noun
dûudûu	Noun
dü	Verb
dükë	Noun
düngö	Noun
dütïngö 	Noun
edêe	Verb
eglîze	Noun
en	Formule d'acceptation
eskalie	Noun
esêle	Noun
fadë	Adverb Tense_aspect_modality
fadësô	Adverb
fafadë	Adverb
fafadësô	Adverb
fambele	Noun
famïi	Noun
fandarä	Noun
farânga	Noun
farânzi	Noun
femba	Noun
fenêtere	Noun
fi	Adjective
fige	Noun
finî	Adjective
fokôn	Noun
folondingi	Noun
fondo	Noun
fono	Verb Noun
fonônö	Noun
foro	Verb
forôto	Noun
fotöo	Noun
foä	Noun
fufû	Noun
fufûu	Noun
fuku	Noun
futîi	Verb
fâ	Verb
fâa	Noun
fânî	Noun
fä
fängö-yäkä	Noun
fêen	Noun
fîon	Noun
fôlôlô	Noun
fôrôrô	Noun
föndo	Noun
fû	Verb
fûru	Noun
fûta	Verb Noun
fûu	Noun
fü	Verb
fün	Verb
füngö	Noun
fütängö	Noun
gaduru	Noun
galâ	Noun
gamvara	Noun
gandâ	Noun
ganga	Noun
ganyêe	Verb
ganzâ	Noun
gapa	Noun
garâ	Noun
gata	Noun
gba	Verb
gbaa	Adverb
gbadôla	Noun
gbadôra	Noun
gbagbagba	Ideophone
gbagbara	Noun
gbakô	Noun
gbalâka	Noun
gbangba	Verb
gbanza	Noun
gbara	Noun
gbarabübä	Noun
gbari	Noun
gbe	Noun
gbe-dê	Noun
gbefâ	Noun
gbegô	Noun
gbegôbîâ	Noun
gbegôgbïä	Noun
gbemïngo	Noun
gbenyôgbïä	Noun
gberê	Noun
gbikï	Noun
gbogbo	Noun
gbongô	Noun
gbudu	Verb
gbugburu	Verb
gburuka	Verb
gbâ	Noun
gbâdêkûa	Noun
gbâgba	Noun
gbâküä	Noun
gbânda	Noun
gbândä	Adverb
gbânzi	Verb
gbânî	Adjective
gbâzâ	Noun
gbâzâbängâ	Noun
gbä	Adverb
gbägbä	Noun
gbägbära	Adjective
gbägbärä	Noun
gbätä	Noun
gbë	Verb
gbîan	Verb
gbîanngbi	Verb
gbï	Verb
gbïngö	Noun
gbïä	Verb
gbô	Verb
gbôgbôlinda	Noun
gbôkorobô	Noun
gbôkorô	Noun
gbôkôrô	Noun
gbôto	Verb
gbötöngö	Verb
gbû	Verb
gbüngö-li	Noun
ge	Locative
gene	Noun
gerê	Noun
gerêmbëtï	Noun
gi	Verb
gidi	Verb
gira	Noun
giriri	Adverb
girisa
gitäre	Noun
gobo	Noun
godobe	Noun
gogoro	Noun
goigôi	Noun
govoroma	Noun
goyâve	Noun
gozo	Noun
gravië	Noun
gue	Verb
gä	Verb
gängö	Noun
gë	Verb
gîgî	Noun
gîâ	Verb
gï	Adverb
gïngö	Verb
gïngö-nyama	Noun
gïngö-susu	Noun
gô	Noun
gôlô	Noun
gônda	Verb Noun
gôro	Noun
gömbâyä	Numeral
gûên	Verb
gûî	Noun
gü	Verb
gügü	Noun
gügümä	Noun
gümbâyä	Noun
gündâ	Noun
gürü	Noun
güëngö	Noun
halë	Noun
halëzo	Noun
hara	Verb
harara	Verb
hasa	Verb
huru	Verb
hurukuzü	Noun
hâ	Verb
hâka	Verb
hânda	Verb
hânge	Interjection
hâriyâ	Verb
hä	Verb
hän	Verb
hängö-lê	Noun
hë	Verb
hînga	Verb
hîni	Verb
hînön	Noun
hîo	Adverb
hôle	Verb
hôlôlô	Adjective
hôn	Noun
hônde	Verb
hônzi	Verb Noun
hölëngö	Noun
hömbä	Noun
hön	Verb
hötö	Noun
hûle	Verb
hûlûhûlû	Noun
hûnda	Verb Noun
hûnzi	Verb
hûru	Verb
hûrûhûrû	Noun
hü	Verb
hümä	Noun
hüngö	Noun
hünzïngö	Noun
iriyâ-yâ
ka	Tense_aspect_modality
kabinëe	Noun
kadâ	Noun
kadöo	Noun
kafäre	Noun
kakaûka	Noun
kalambo	Noun
kalaöo	Noun
kalesön	Noun
kalä	Noun
kamaräde	Noun
kamba	Noun
kambîri	Noun
kambûsu	Noun
kamelä	Noun
kamâ	Noun
kamâ-kîte	Noun
kamâ-porosö	Noun
kamâ-ôko	Noun
kamâta	Verb
kamême	Subordinating connective
kamënë	Noun
kanda	Noun
kandâ	Noun
kandâa	Coordinating connective
kangamëe	Noun
kangba	Noun
kange	Noun
kangi	Noun
kangoya	Noun
kangû	Noun
kanivöo	Noun
kanäna	Noun
kanäre	Noun
kanîfu	Noun
kanîvo	Noun
kapï	Noun
kapïta	Noun
kara	Verb
karagbikï	Noun
karakânzi	Noun
karapîri	Adjective
karavâti	Noun
kasa	Verb
kate	Noun
katikâti	Noun
kautchü	Noun
kawoya	Noun
kayimän	Noun
kayëe	Noun
kaziêe	Noun
kazâka	Noun
ke	Verb
kelekpâ	Noun
kerekpâ	Noun
keremba	Noun
keretïen	Noun
kerëvête	Noun
kilôti	Noun
kilöo	Noun
kinda	Verb
kinda-gozo	Noun
kinîni	Noun
kipêe	Verb
kiri	Noun
kisoro	Noun
kisêre	Noun
kizamä	Noun
kobêla	Noun
kodë	Noun
kodëlêgë	Noun
koko	Noun
kokora	Noun
kokoro	Noun
kokôro	Noun
kokö	Noun
koli	Noun
kolongo	Noun
kolêe	Verb
kolîngo	Noun
kolôfîâ	Noun
komandêe	Verb
kombo	Noun
kombâ	Noun
komense	Verb
kondêe	Noun
kongba	Noun
kongä	Noun
kongö	Noun
kono	Verb
konza	Noun
konô	Noun
kopo	Noun
koro	Verb
korobô	Noun
korogbô	Noun
korôro	Noun
koso	Noun
koto	Verb
koto-mo-längö	Noun
kotöon	Noun
kpa	Verb
kpaka	Verb
kpakatawâ	Noun
kpakete	Noun
kpakpakpa	Ideophone
kpakpö	Noun
kpangba	Noun
kpangbala	Noun
kpangbara	Noun
kpangäbä	Noun
kpasa	Noun
kpasâkärä	Noun
kpata	Noun
kperekpere	Ideophone
kpo	Verb
kporo	Verb
kpoto	Noun
kpu	Noun
kpâa	Adverb
kpâkayâo	Noun
kpâku	Noun
kpâlâköngö	Noun
kpângbi	Noun
kpângbârâ
kpângi	Noun
kpârâköngö	Noun
kpälë	Noun
kpändä	Adjective
kpêe	Verb
kpêne	Noun
kpêngba	Verb
kpë	Noun
kpëngbä	Adjective
kpëngbä-bê	Noun
kpëngbërë	Noun
kpîi	Verb
kpîkara	Noun
kpîngba	Verb
kpîtîkpîtî	Ideophone
kpï	Noun
kpïndïrï	Noun
kpïngbä	Adjective
kpô	Noun
kpôkpô	Noun
kpöka	Noun
kpûkpû	Noun
kpûku	Noun
kpüngbülümûse	Noun
kroa	Noun
kua	Noun
kuasînga	Noun
kubû	Noun
kugbë	Noun
kugbë-sängbä	Noun
kukûna	Adjective
kumbämbä	Noun
kundi	Noun
kundâ	Noun
kupkup	Noun
kuräan	Noun
kusâla	Noun
kusâra	Noun
kutubôn	Noun
kutukutu	Noun
kâ	Locative
kâi	Verb
kâkâkâ	Interjection
kâlângbâ	Noun
kâmba	Noun
kânasûkre	Noun
kânga	Noun
kângame	Noun
kângbi	Verb Noun
kângâ	Noun
kângî	Noun
kâpä	Noun
kâra	Noun
kârâkö	Noun
kârângbâ	Noun
kâsa	Noun
kâta	Noun
kâwa	Noun
kâya	Noun
kâî	Noun
kä	Verb
kêkerêke	Adverb Noun
kêlêlê	Noun
kêre	Noun
kêrêrê	Noun
kêsi	Noun
kêtê	Quantifier Adjective
kêü	Noun
këkë	Noun
këkë-wâ	Noun
këkëmbëtï	Noun
këngë	Noun
këngö-terê	Noun
këngû	Noun
kî	Noun
kînda	Noun
kîo	Verb
kîri	Verb
kîrîkiri	Adverb Adjective
kîsîrî
kîte	Noun
kîzi	Noun
kïlömêtere	Noun
kïrïngö	Noun
kïrïngö-tënë	Noun
kïön	Noun
kôbe	Noun
kôgarâ	Noun
kôkô	Noun
kôkôkô	Ideophone
kôlï	Noun
kôlï-bâgara	Noun
kôlï-gaduru	Noun
kôlï-kôndo	Noun
kôlï-likundû	Noun
kôlï-mbârâtâ	Noun
kôlï-müä	Noun
kôlï-ngäsa	Noun
kôlï-taba	Noun
kôlï-tâgba	Noun
kôlô	Noun
kôlökôtö	Noun
kômbe	Noun
kônde	Noun
kôndo	Noun
kôro	Verb
kôsö	Noun
kôya	Noun
kôzo	Adverb
kôzonî	Adverb
kö	Verb
ködrö	Noun
ködrösêse	Noun
ködä	Noun
ködörö	Noun
kömändâ	Noun
kömändëmä	Noun
kömë	Noun
köngbö	Noun
könöngö	Noun
körö	Noun
kötarä	Noun
köto	Noun
kötä	Adjective
kötï	Noun
kûi	Verb
kûku	Noun
kûkulû	Noun
kûkurû	Noun
kûkû	Noun
kûma	Noun
kûndû	Noun
kûngbi	Verb
kûngbâ	Noun
kûngûrûbä	Noun
kûtu	Numeral
kûâ	Noun
kûê	Adverb Quantifier
kü	Verb
külä	Noun
kündü	Noun
kürü	Adjective
kütu	Noun
küä	Noun
küä-ngbagba	Noun
küä-nyön	Noun
küä-yângâ	Noun
lakerëe	Noun
lakpängbä
lakërë	Noun
lamerï	Noun
lamânde	Noun
lando	Noun
langä	Noun
lapärä	Noun
lapôo	Noun
lavu	Noun
laâ	Demonstrative
leke	Verb
lekpa	Noun
lele	Noun
lembë	Noun
lenge	Noun
lesua	Verb
lesöon	Noun
letäa	Noun
li	Noun
libanëe	Noun
likisi	Noun
likongô	Noun
likundû	Noun
liködörö	Noun
likünï	Noun
likünü	Noun
limo	Noun
linda	Verb
lingö-zegbesa	Noun
lingû	Noun
lisorö	Noun
litënë	Noun
lo	Pronoun
lokpoto	Noun
lungûla	Verb
lurêe	Verb
luêe	Verb
lâ	Noun
lâi	Noun
lâkûi	Noun
lâkûê	Adverb
lâmba	Noun
lâme	Noun
lânî	Adverb
lâpôso	Noun
lâsô	Adverb
lâwa	Interrogative pro-form
lâyenga	Noun
lâûlâû	Ideophone
längö	Noun
lê	Noun
lêgë	Noun
lêgëôko	Adverb
lêmbëtï	Noun
lêne	Noun
lêngua	Noun
lêyäkä	Noun
lë	Verb
lë-gbïä	Verb
lëgô	Noun
lëlë	Noun
lëndâ	Noun
lësüängö	Noun
lîga	Noun
lîkirî	Noun
lîngbi	Verb Tense_aspect_modality
lîtere	Noun
lï	Verb
lïngbïngö	Noun
lïngä	Noun
lïngî	Noun
lïngö	Noun
lôlo	Noun
lôro	Noun
lôso	Noun
löndö	Verb
lörö	Noun
lûmbâlumba	Adjective
lü	Verb
lütï	Verb
ma	Interjection
mabôko	Noun
mafüta	Noun
maka	Noun
makabo	Noun
makala	Noun
makara	Noun
makongö	Noun
makoröo	Noun
makâko	Noun
makönzi	Noun
makûu!	Interjection
makünzi	Noun
malînga	Noun
mambö	Noun
mamâ	Noun
mamâ-kêtê	Noun
mamâ-kötä	Noun
mamîwatâ	Noun
mamïön	Noun
manda	Verb
mandako	Noun
mandërë	Noun
mangbêlê	Noun
mangbêrê	Noun
mangbökö	Noun
mankêe	Verb
mapîâ	Noun
marabüu	Noun
martoo	Noun
marâra	Noun
marä	Noun
marä-belü	Noun
maseka	Noun Adjective
maseka-kôlï	Noun
maseka-wâlï	Noun
masîni	Noun
masïni	Noun
matabïsi	Noun
mataläa	Noun
mateläa	Noun
mato	Noun
matânga	Noun
mawa	Noun
mayëen	Noun
mayëre	Noun
mazïi	Noun
mbadi	Noun
mbai	Noun
mbamba	Noun
mbanda	Noun
mbanga	Noun
mbele	Noun
mbere	Noun
mbeso	Noun
mbeto	Noun
mbimba	Noun
mbipa	Noun
mbo	Noun
mbongo	Noun
mbrâmbrâ	Numeral
mbumbuse	Adjective
mbunzû	Noun
mbupa	Noun
mbâ	Noun
mbâgë	Noun
mbângi	Noun
mbângö	Noun
mbârâmbârâ	Numeral
mbârâtâ	Noun
mbäkôro	Noun
mbänä	Noun
mbätä	Noun
mbênî	Adverb Quantifier Adjective
mbëlä	Noun
mbëngë	Noun
mbëtï	Noun
mbëtïkâpä	Noun
mbëtïsango	Noun
mbîndä	Noun
mbîngö	Noun
mbîrîmbîrî	Adjective
mbï	Pronoun Noun
mbïö	Noun
mbôko	Verb Noun
mbômbô	Adjective
mbôo	Verb
mbôrô
mbö	Noun
mbörörö	Noun
mbûki	Noun
mbûrü	Noun
mbürü	Noun
mbütü	Noun
me	Connective
meambe	Numeral
mekemeke	Ideophone
mene	Verb
meniz(y)ëe	Noun
meredêe	Verb
meresî	Noun
midïi	Noun
mimîi	Adjective
mini	Noun
minimîni	Noun
miombe	Numeral
mire	Noun
miro	Verb
mo	Pronoun
mobimba	Adjective
modô
mokondö	Noun Adjective
mokpäkpä	Noun
mokönzi	Noun
molongö	Noun
montêe	Verb
monya	Noun
mosoro	Noun
mosümä	Noun
motöo	Noun
mozoko	Noun
munzû	Noun
mustikëre	Noun
mve	Noun
mvele	Noun
mvene	Noun
mvenî	Noun
mvuka	Noun
mâi	Verb
mâlegbängä	Noun
mânga	Noun
mângo	Noun
mâpa	Noun
mâsa	Noun
mâsarâgba	Noun
mâtâmâtâ	Adjective
mâzawîli	Noun
mä	Verb
mäbê	Noun
mängö-terê	Noun
mäpö	Noun
märïâzi	Noun
mäïngö	Noun
mê	Noun
mêche	Noun
mêlengê	Noun
même	Adverb
mênë	Noun
mêse	Noun
mêtere	Noun
mêzä	Noun
mêä	Noun
më	Verb
mëngä	Noun
mî	Noun
mîngi	Quantifier
mîngo	Verb
mînî	Noun
mîterê	Noun
mï	Verb
môlengê	Noun
môlengê-kôlï	Noun
môlengê-wâlï	Noun
möngûste	Noun
mû	Verb
mûpe	Noun
müngö-terê	Noun
müä	Noun
na	Connective Preposition
nabändurü	Noun
naâmo	Noun
ndadë	Adverb
ndangba	Adjective
ndao	Noun
ndaramba	Noun
ndarä	Noun
ndaû	Noun
ndefi	Noun
ndeke	Noun
ndeko	Noun
ndembë	Noun
ndembö	Noun
ndikâ	Noun
ndima	Noun
ndiä	Noun
ndo	Noun
ndo-wâ	Noun
ndokua	Noun
ndokôro	Noun
ndombe	Noun
ndonga	Noun
ndongere	Noun
ndoyî	Noun
ndurü	Adjective
ndâ	Noun
ndâmbo	Quantifier Noun
ndângbâ	Noun
ndângôrö	Noun
ndânî	Noun
ndârâ	Noun Adjective
ndârârâ	Adverb Noun
ndâyä	Noun
ndäprê	Noun
ndäpêrê	Noun
ndäpêrêrê	Noun
ndê	Adverb Adjective
ndêndê	Adverb Adjective
ndôngô	Noun
ndö	Noun
ndönî	Adverb
ndöyê	Verb Noun
ndûmbu	Adjective
ndûmbâ	Noun
ndûrûkpâ	Noun
ndü	Verb
ndümbü	Noun
ndüzü	Noun
ne	Verb
neka	Verb
nenêe	Adjective
ngadï	Noun
ngadï-ngû	Noun
ngambe	Noun
nganda	Noun
nganga	Noun
ngangü	Adverb Noun Adjective
ngarä	Noun
ngbanga	Noun
ngbangbo	Numeral
ngbangäzâ	Noun
ngbengê	Noun
ngberere	Noun
ngbii	Ideophone
ngbondâ	Noun
ngbonga	Noun
ngbongbôlo	Quantifier Noun
ngbongbôro	Quantifier Noun
ngborô	Noun
ngbum	Ideophone
ngbâ	Verb
ngbâa	Noun
ngbâko	Noun
ngbângbâ	Noun
ngbä	Noun
ngbädä	Noun
ngbäkpä	Noun
ngbätï	Noun
ngbêne	Adjective
ngbêre	Adjective
ngbëndä
ngbëngbë	Noun
ngbïngbï	Noun
ngbö	Noun
ngbökö	Noun
ngböngö	Noun
ngbûku	Noun
nge	Verb Adjective
ngendë	Noun
nginza	Noun
ngira	Noun
ngo	Noun
ngoalö	Noun
ngoangoa	Noun
ngolo	Noun
ngombe	Noun
ngombî	Noun
ngombï	Noun
ngonda	Noun
ngongoa	Noun
ngongü	Noun
ngonzo	Noun
ngonzâ	Noun
ngoro	Verb
ngubë	Noun
ngundë	Noun
ngungu	Noun
ngunzä	Noun
nguru	Verb Noun
ngurugbïä	Noun
ngusü	Noun
nguzü	Noun
ngâ	Adverb
ngâakô	Noun
ngâfô	Noun
ngâgö	Noun
ngâsi	Verb
ngängä	Noun
ngängängä	Ideophone
ngäsa	Noun
ngäsangbaga	Noun
ngäsâ	Noun
ngêli	Adjective
ngêrêrê	Noun
ngêrë	Noun
ngëngö	Noun
ngîri	Noun
ngîâ	Noun
ngô	Verb
ngôbo	Noun
ngôi	Noun
ngôlô	Noun
ngômbï	Noun
ngôngbi	Noun
ngôongô	Noun
ngö	Noun
ngölï	Noun
ngömbo	Noun
ngöngonö	Noun
ngû	Noun
ngû-Nzapä	Noun
ngû-lavu	Noun
ngû-îngö	Noun
ngûlê	Noun
ngûngbi	Noun
ngûngunzä
ngûru	Noun
nika	Verb
nyama	Noun
nye	Interrogative pro-form
nyen	Interrogative pro-form
nyenye	Noun
nyenyen	Noun
nyâön	Noun
nyâü	Noun
nyëkpä	Noun
nyïndû	Noun
nyön	Verb
nzapä	Noun
nzara	Noun
nze	Noun
nzenze	Noun
nzere	Verb
nzombö	Noun
nzorôko	Noun
nzêen	Verb
nzêne	Verb Adjective
nzêre	Verb Adjective
nzêrê	Noun
nzënë	Noun
nzërëngö	Noun
nzîna	Verb Adjective
nzï	Verb
nzö	Noun
nzöbê	Noun
nzönî	Adverb
nzönî-bê	Noun
nzönî-kûê	Adverb Adjective
nzöpäsä	Noun
nâkö	Noun
nëngö	Noun
nî	Demonstrative
nînga	Verb
nï	Pronoun
nïkpä	Noun
nïngängö	Adjective
nïväkîni	Noun
okü	Numeral
omënë	Numeral
omö	Noun
orânje	Noun
osïö	Numeral
otâ	Numeral
otöo	Noun
palâse	Noun
palâta	Noun
palü	Noun
pandalö	Noun
pandë	Noun
panzâka	Verb
panzê	Verb
papa	Verb Noun
papâi	Noun
papâye	Noun
parara	Noun
pardonêe	Verb
pardön	Noun
parâba	Noun
pasêe	Verb
pasëe	Verb
pasûla	Verb
patalöon	Noun
patröon	Noun
pekë	Noun
pekô	Noun
pekônî	Noun
pelikan	Noun
pendere	Noun Adjective
pendere-kôlï	Noun
pendere-wâlï
pendâ	Noun
pepe	Verb
pete	Verb
petoröle	Noun
petoröo	Noun
peyêe	Verb
pialö	Noun
pikîri	Noun
pinîi	Verb
pito	Noun
pitäan	Noun
pizöon
plase
pokô	Noun
polêlê	Adverb
polîsi	Noun
ponö	Noun
popôto	Noun
popö	Noun
porosö	Noun
potopôto	Noun
pupu	Noun
pupë	Noun
purû	Noun
pusiëre	Noun
pusupûsu	Noun
pândi	Noun
pâpâlâpö	Noun
pâpä	Noun
pâsi	Noun
pâta	Noun
pä	Verb
päpälâpö	Noun
pärä	Noun
päräkôndo	Noun
päsä	Noun
pätärä	Noun
pêrë	Noun
pë	Verb
pëmbë	Noun
pëpe	Adverb
pëtë	Noun
pîda	Verb
pîka	Verb
pîri	Noun
pîtîpîtî	Ideophone
pïkängö	Noun
pïndïrï	Noun
pôlôlô	Noun
pônde	Noun
pôndi	Noun
pôngô	Noun
pônte	Noun
pö	Noun
pöpö	Noun
pöpö-hötö	Noun
pörö	Noun
pûpûlenge	Noun
pûsu	Verb
pûsu-purû	Noun
pûsupûsu	Noun
pümbä	Noun
radïo	Noun
rambâi	Noun
rulêe	Verb
rumbatêe	Verb
rêk	Ideophone
rô	Verb
sa	Noun
sabângo	Noun
sakpa	Verb
sakpä	Noun
salëtë	Noun
sambele	Noun
sambâ	Noun
sambêla	Verb Noun
sana	Noun
sandâka	Noun
sandûku	Noun
sangbi-lêgë	Noun
sango	Noun
sangû	Noun
sanzê	Verb
sara	Verb
sarapandëe	Noun
saratë	Noun
sasa	Verb Noun
savöno	Noun
seko	Noun
selêka	Noun
sembë	Noun
sepela	Verb
serême	Noun
si
sibisïi	Noun
sifön	Noun
simän	Noun
sindi	Noun
singîla	Noun
siri	Noun
sirîki	Noun
sisi	Noun
sisongo	Noun
sisä	Noun
sitrön	Noun
sizöö	Noun
so	Verb
sobêle	Noun
sobîsi	Noun
sodäa	Noun
soko	Verb
sokoto	Noun
son	Verb
sopo	Noun
soro	Verb
sosongo	Noun
su	Verb
sua	Verb
suali	Noun
sukûla	Verb
sulêe	Verb
sumâle	Noun
sumâli	Noun
sungba	Verb
surä	Noun
susu	Noun
suîya	Noun
sâa	Verb
sâki	Noun
sâko	Noun
sâla	Verb Noun
sân-tî-tene	Connective
sândâga	Noun
sânzêri	Noun
sânzîrî	Noun
sâra	Verb Noun
sämba	Noun
sängö	Noun
sänzö	Noun
särä	Noun
sê	Noun
sê-gbënë	Noun
sêgô	Noun
sêlörö	Noun
sên	Noun
sêndâ	Noun
sêndâ-yê	Noun
sêngbondö	Noun
sêngê	Adverb Adjective
sênkëre	Noun
sênî	Noun
sêse	Noun
sêterê	Noun
sêtâ	Noun
së	Verb
sën	Noun
sëndë	Noun
sëngö	Verb
sënë	Noun
sërë	Noun
sëwä	Noun
sîi	Noun
sînga	Noun
sîrîrî	Noun
sîtâ	Noun
sï	Verb
sïgî	Verb
sïgîgî	Verb
sïökpärï	Noun
sïönî	Adverb Noun Adjective
sïönî-bê	Noun
sô	Verb
sôn	Verb
sôo	Noun
sö	Verb
sökö	Noun
söngö	Noun
sönsôn	Verb
sörö	Noun
sösö	Noun
sû	Verb
sûkere	Noun
sûku	Verb
sûkûru	Noun
sûmbû	Noun
sûpu	Noun
sûru	Verb
sümä	Noun
süä	Noun
süäli	Noun
ta	Noun
taba	Noun
tambêla	Verb
tambûla	Verb Noun
tanda	Verb
tanga	Noun
tangë	Noun
tara	Verb
tarä	Noun
tasêse	Noun
tatalîta	Noun
tatara	Verb
tatärä	Noun
tawâ	Noun
taâ	Adverb Adjective
te	Verb
tembe	Noun
tene	Verb
tere	Noun
terê	Noun
tezôon	Noun
tikîsa	Verb
timöon	Noun
tiri	Verb Noun
tirika	Verb
to	Verb
tokua	Verb Noun
toli	Noun
tomba	Verb
tombôka	Verb Noun
tomâte	Noun
tondo	Verb
tongoro	Noun
torôtorô	Adverb
toröo	Adverb Quantifier
toto	Verb Noun
tufa	Noun
tukîa	Noun
tumba	Verb
tumbûka	Verb Noun
turnêe	Verb
turunêe	Verb
turûgu	Noun
turûngu	Noun
tâbolo	Noun
tâboro	Noun
tâburu	Noun
tâgba	Noun
tâkâ	Noun
tâmuru	Noun
tângo	Noun
târârâ	Ideophone
tä	Verb
tängö	Noun
täpandë	Noun
tätärängö	Noun
tê	Noun
têke	Noun
têmë	Noun
têngbi	Verb
tênë	Noun
tënë	Noun
tëtî	Connective
tî	Preposition
tîa	Verb
tîko	Verb
tîkö	Noun
tîngbi	Verb
tîsa	Verb
tîtene	Subordinating connective
tï	Verb
tïgatï	Noun
tïngö	Noun
tïängö	Noun
tôndôrô
tôndö	Noun
tôngbi	Verb
tôreche	Noun
tö	Verb
tömbërä	Verb
töndö	Noun
töngana	Subordinating connective
töngasô	Adverb
töngömbo	Noun
törö	Noun
tûku	Verb Noun
tûu	Quantifier
tûutûu	Noun
tüküngö	Noun
uga	Noun
ukü	Numeral
uru	Verb
usïö	Numeral
vaa	Adverb
vaka	Noun
veke	Noun
vekë	Noun
velöo	Noun
vene	Noun
vi	Noun
visêe	Verb
vo	Verb
vokö	Adjective
vonga	Verb
vongbâ	Noun
voro	Verb
votêe	Verb
vovoro	Noun
vukö	Adjective
vulü	Adjective
vundü	Noun
vuru	Verb
vurü	Adjective
vâla	Noun
vâlä	Noun
vârä	Noun
vävärä	Noun
vêre	Noun
vîi	Adverb
vôko	Verb
vôte	Noun
vûko	Verb
vûnga	Verb
vü	Verb
vümä	Noun
wa	Interrogative pro-form
wa-mänzä	Noun
wabätängö-nyama	Noun
wabûburû	Noun
wadëngö-büzë	Noun
wadôdô	Noun
wagôsînga	Noun
wahânda	Noun
wahöngö-zo	Noun
wakodë	Noun
wakua	Noun
wakânga	Noun
wakälä	Noun
wakëngö-zo	Noun
wakînda	Noun
waködörö	Noun
waküâ	Noun
wala	Connective
walikundû	Noun
walimo	Noun
walombë	Noun
walâ	Interjection
wamandako	Noun
wambëtï	Noun
wamosoro	Noun
wamoyayäa	Noun
wamvene	Noun
wamäbê	Noun
wamändängö-kua	Noun
wamändängö-mbëtï	Noun
wamüä	Noun
wandarä	Noun
wandê	Noun
wanganga	Noun
wangangü	Noun
wanguru	Noun
wangën-längö	Noun
wanzînga	Noun
wanzï	Noun
wara	Verb
wasopo	Noun
wasïökpärï	Noun
wasöngö	Noun
wasüngö-mbëtï	Noun
wato	Noun
watokua	Noun
wawängö	Noun
wayângâ-Nzapä	Noun
wayërë	Noun
wayïndä	Noun
waziba	Noun
wazïn	Noun
wuga	Noun
wâ	Noun
wâli-ndûmbu	Noun
wâlï	Noun
wâlï-bâgara	Noun
wâlï-gaduru	Noun
wâlï-kôndo	Noun
wâlï-likundû	Noun
wâlï-mbârâtâ	Noun
wâlï-müä	Noun
wâlï-tâgba	Noun
wârâga	Noun
wäfängö-lêgë	Noun
wängö	Noun
wätäkä	Noun
wêen	Verb
wên	Noun
wôko	Verb
wôlôlô	Adjective
wôtoro	Noun
wö	Verb
wöngö	Noun
wöngö-terê	Noun
wûlûwûlû	Noun
wûsûwusu	Noun
wü	Verb
wümä	Noun
wüngö	Noun
ya	Verb
yamba	Adverb
yambatï	Noun
yangba	Noun
yangö	Noun
yeke	Verb
yekia	Verb
yenga	Noun
yengere	Verb Noun
yingö	Noun
yingö-va	Noun
yo	Verb
yongo	Noun
yongôro	Adverb Adjective
yorö	Noun
yoya	Verb
yuru	Verb
yâ	Noun
yâa	Verb
yândo	Noun
yângbö	Noun
yângâ	Noun
yângâ-da	Noun
yânî	Noun
yâpu	Verb
yäkä	Noun
yändä	Noun
yäsä	Noun
yäyû	Noun
yê	Verb
yêda	Verb
yêkpâ	Noun
yëngërë	Noun
yëngö-terê	Noun
yërë	Noun
yîngi	Verb Noun
yïnda	Verb
yïndû	Noun
yô	Verb
yôo	Interjection
yôro	Verb
yömbö	Noun
yöngö	Noun
yüngö-ndo	Noun
zamba	Noun
zambala	Noun
zambêrê	Noun
zamêe	Adverb
zaragîna	Noun
zaranga	Noun
zari	Noun
zaza	Noun
zazama	Verb
ze	Noun
zegë	Noun
zekë	Noun
zekëzekë	Noun
zembe	Noun
zeme	Noun
zen	Noun
zere	Verb
zigidâ	Noun
zingîri	Noun
zo	Noun
zonga	Verb Noun
zonyön	Noun
zovokö	Noun
zovukö	Noun
zozo	Noun
zâbalo	Noun
zä	Verb
zêe	Verb
zênê	Verb
zëndo	Noun
zëndë	Noun
zî	Verb
zîa	Verb
zîngo	Verb
zï	Verb
zïngöngö	Noun
zôâ	Noun
zö	Verb
zöröndö	Verb
zû	Verb
zûku	Verb
zûsuka	Subordinating connective
zûu	Verb
zûâ	Noun
â-	Noun
âde	Adverb
âdu	Marqueur d'hypothese
âgbâkûrû	Noun
âki	Noun
âkûngbâ	Noun
âla	Pronoun
âmaseka	Noun
âmetë	Noun
âmosoro	Noun
ânarûmbatêe	Noun
ânde	Particle
ândö	Adverb
ânï	Pronoun
âreyâ	Noun
âsango	Noun
äpe	Adverb
ên-ën	Formule de desapprobation
ë	Pronoun
ëdëngö-zo	Noun
ëkâe	Noun
îngö	Noun
înön	Noun
îri	Verb
îtä	Noun
ï	Pronoun
ïrï	Noun
ô	Noun
ôke	Interrogative pro-form
ôko	Numeral
ôtoro	Noun
öberzîne	Noun
ömba	Noun
ötö	Noun
ûru	Verb
ûse	Numeral
