A
ayü : ayou

B
bârzi : barge
bätängö gbakô : forêt protégée
bengbä-këkë : bois rouge
bîyi : grume
bîyi tî këkë : bille de bois
buba gbakô; zî këkë : déboiser
bübängö gbakô : déboisement
bübängö-gbakô : déforestation

D
dasürüngö mabäyä : scierie
dë kätï : ebrancher
döngö : empilage
döngü gbakô : forêt classée
döngö lêndo : site classé
döngö-këkë : entreposage
dono-këkë : marteau forestier
dörömâni, sîi ; tronçonneuse

F
fâ na sîi : tronçonner
fâa këkë ; abattre un arbre
fâa këkë : couper du bois
fängö këkë ; coupe de bois
fängö-këkë : abattage d'arbre
fängö-këkë na mabôko : abattage traditionnel

14

fängö-këkë na masïni : abattage mécanique
finî lüngö-këkë : reboisement

G
gara : elaguer
gärängö : elagage
gbâkëkë : empilement
gbakô : forêt
gbakô lëngö-mosoro : forêt de production
gbakô-lipë : forêt récréative
gbâkugbë : feuillage

K
kâmba tî gbakô : liane
kara-kangi : ebène
këkë : arbre
këkë : bois
këkë tî gbadara : bois d'oeuvre
këkë tî ngunuwâ : bois de service
këkëwâ : bois de chauffe
kêtê mabôko-këkë ; rameau
kêtê-këkë : arbuste
kôndreplakëe : contreplaqué
kutukutu tî yöngö-këkë : grumier

L
lâte : latte
lêgë gbötöngö-këkë : chemin de triage
leke yâ tî gbakô : aménager une forêt
lëkëngö-yâ tî gbakô : aménagement forestier
lêndo tî âbangë ; site botanique
lü këkë : reboiser

15

lüngö finî marä : alternance

M
madriyêe : madrier
mäïngö-gbakô : reforestation
marä këkë : essence de bois
masïni fängö-këkë : abatteuse
masïni-döngö : empileuse
masïni-kätï : ebrancheuse
mïngö gbakô : forêt dense
mbïö : acajou

N
ndo tïngö-këkë : lit
ndurü-këkë : rondin
ngonda : galerie forestière
ngbonga-këkë : tronc
ngbongbôro këkë : bois en grume
nzerë : triangle forestier
nzerë libakû : marque triangulaire
nzerë-dono : empreinte du marteau

O
okumëe : okoumé

P
pörökëkë : ecorce d'arbre
pösä gbakô : forêt clairsemée

16

S
sapelï : sapeli
sêkônde tî gbakô : audit forestier
sêkua gbakô : forestage
sêlëngö gbakô : foresterie
sêmêtere-këkë : cubage de bois
sêndâgbakô : sylviculture
sêngê gbakô : forêt secondaire
sevron : chevron
sêyâmêtere ôko, mêtere-yâ ôko : stère
sîgî na këkë : débarder
sïgïngö-këkë : débardage
sïökëkë : bois déclassé
sûru mabäyä : scier du bois
sürüngö mabäyä : sciage de bois

T
tâkâ gbakô : forêt primaire

V
vurü-këkë : bois blanc

W
wafängö-këkë : bûcheron
wakua tî ebêni : ebéniste
wakua tî ngû na gbakô : agent des eaux et forêts
wasêndâgbakô : sylviculteur

Y
yângâ-këkë : chute de bois

17

Z
zî pörökëkë : dérouler une bille de bois
zïängö gbakô : forêt déclassée
zïängö nzerë na këkë: marquage d'un arbre
zïngö këkë : déboisement
zïngö-pörökëkë : déroulage
zöngö-pïndïrí : bois de carbonisation

18
