-nga	Suffix
-ngbi	Suffix
-ngɔ̈	Suffix
ä	Noun
â	Verb
a	Verb
â-	Prefix
ababâa	Noun
âdɛ	Adverb
âdu	
afirîka	Noun
ahɔ̈n	Adverb
ahɔ̈ndɔ̈nî	Adverb
âla	Pronoun
âla mvɛnî	
alë	Noun
âmbeso	Noun
amerîka	Noun
ânarûmbatêe	Noun
andâa	Conjuction
ândɛ	
ândö	Adverb
ânge	Interjection
angɛlêe	Noun
ânî	
ânï	
äpɛ	
ara	Verb
arara	Noun
asa	Verb
asî na	Preposition
asî na ... awe	Preposition
âta	Noun
aü	Noun
awâne	Noun
awɛ	
bä	Noun
bâ	Noun
ba	Verb
bâ-	Prefix
bâ-ndembö	Noun
bâ-ülë	Noun
bâ-wërë	Noun
bâa	Verb
bâa mo tɛnɛ	Conjuction
bâanga	Verb
baba	Noun
babâ	Noun
bâbâ	Noun
babâla	Noun
bäbɔrɔ	Noun
badâ	Noun
bâgara	Noun
bagbara	Noun
bakarî	Noun
bäkɔngɔ̈	Noun
bäkoyä	Noun
bäkpä	Noun
bäkürü	Noun
bakûtu	Noun
balâmbo	Noun
bâlâwâ	Noun
balë	Adjective
bale	Noun
balë-mbârâmbârâ	Adjective
balë-mbâsâmbârâ	Adjective
balë-miɔmbe	Adjective
balë-ngümbâyä	Adjective
balë-ɔ̈kɔ	Adjective
balë-ɔ̈kɔ na mbârâmbârâ	Adjective
balë-ɔ̈kɔ na mbâsâmbârâ	Adjective
balë-ɔ̈kɔ na miɔmbe	Adjective
balë-ɔ̈kɔ na ngümbâyä	Adjective
balë-ɔ̈kɔ na ɔkü	Adjective
balë-ɔ̈kɔ na omɛnë	Adjective
balë-ɔ̈kɔ na otâ	Adjective
balë-ɔ̈kɔ na üse	Adjective
balë-ɔ̈kɔ na üsïô	Adjective
balë-ɔkü	Adjective
balë-omɛnë	Adjective
balë-otâ	Adjective
balë-üse	Adjective
balë-üsïô	Adjective
balêe	Noun Verb
bämarä	Noun
bambinga	Noun
bambü	Noun
bängâ	Noun
banga	Noun
bângbi	Noun Verb
bangi	Noun
bângi	Noun
bangî	Noun
bara	Noun Verb
barama	Interjection
barao	Interjection
basɛ̈nzi	Noun
bata	Verb
bâyâ	Verb
bazïngêre	Noun
bɛ̂	Noun Verb
bë	Verb
bɛ	Verb
bɛ̂-afirîka	Noun
bɛ̂-kɔ̈dɔ̈rɔ̈	Noun
bɛ̂-nyämä	Noun
bɛ̂-zöngö	Noun
bëkpä	Noun
bɛ̂lâawü	Noun
belü	Noun
bema	Verb
bengbä	Adjective
bengbä-bengbä	Adjective
bengbä-kɛ̂tɛ̂	Adjective
bɛ̈ngɔ̈	Adjective
bɛrɛ	Verb
bëtä	Noun
bï	Noun
bî	Noun
bi	Verb
bi bɛ̂	Verb
bi na bɛ̂	Verb
bi-bɛ̂	Noun
bîâ	Noun
bîakü	Adverb
bîängä	Noun
bîanî	Adverb
bîbîbibi	Noun
bibila	Noun
bîɛ̂lɛ	Noun
bïkua	Noun
bïkua-ɔ̈kɔ	Noun
bïkua-ɔkü	Noun
bïkua-otâ	Noun
bïkua-üse	Noun
bïkua-üsïô	Noun
bilarzï	Noun
bindî	Noun
bînga	Verb
bingbi	Noun Verb
biö	Noun
birâ	Noun
bîrï	Adverb
biritâni	Noun
bô	Verb
bobo	Noun
bɔlɛ	Noun
böndö	Noun
bɔngɔ̂	Noun
bɔngɔ̈	Noun
bɔrɔ	Adjective
börö	Noun
bɔ̂sɔ	Verb
bɔ̂sɔngbi	Noun Verb
bozö	Noun
buä	Noun
buä-kɛ̂tɛ̂	Noun
buä-kötä	Noun
buä-mä-na-bɛ̂	Noun
buä-mokönzi	Noun
buä-sû	Noun
buä-tokua	Noun
bübä	Noun
buba	Verb
bûbu	Noun
bubu	Noun
bûburû	Noun
bubûtä	Adjective
bûku	Noun
bulɛ̂ɛ	Noun
bûngbi	Noun Verb
burü	Noun
buruma	Noun
butâni	Noun
butuma	Verb
büzë	Noun
buzî	Noun
da	Noun
dä	Verb
da bɛ̂	Verb
da na bɛ̂	Verb
da-	Prefix
da-bɛ̂	Noun
da-turu	Noun
daä	
dâlâmâ	Noun
dâlë	Noun
damâköngö	Noun
dambâ	Noun
dâmi	Noun
damvɛnɛ	Noun
dândâ	Noun
dânga	Noun
dangâlingâ	Noun
dangara	Noun
dangbö	Noun
dangërë	Noun
dara	Verb
dazo	Noun
dê	Noun
dë	Verb
de	Verb
dɛ̈	Verb
dɛ	Verb
dɛ̈-bä	Verb
dɛ̈-bä-nzɔ̈nî	Verb
dɛ̈-bä-nzɔ̈nî na ndö tî	Verb
dɛ̈-bä-sïɔ̂nî	Verb
dɛ̈-bä-sïɔ̂nî na ndö tî	Verb
dɛ̈-kɔ̈ngɔ̈	
dɛ̈-nzɔ̈-bä	Verb
dɛ̈-nzɔ̈-bä na ndö tî	Verb
dɛ̈-sïɔ̂-bä	Verb
dɛ̈-sïɔ̂-bä na ndö tî	Verb
dëbä	Noun
dëbängɔ̈	
dêfa	Verb
dɛku	Noun
dema	Verb
dema-tɛrɛ̂	Verb
dëmängɔ̈-tɛrɛ̂	Verb
dɛngbɛ	Noun
dênge	Verb
dêngi	Noun
dɛ̈ngɔ̈	
dëngɔ̈	
dɛrɛ̈	Noun
dî	Noun
di	Verb
dï	Verb
didi	Noun
dïdïrï	Noun
dïkï	Noun
dïkïnzï	Noun
dîkɔ̂	Noun
dîkɔ	Verb
dɔ̈	Noun
do	Noun
dɔ̂	Verb
dɔ̈dɔ̈	Noun
dɔdɔ	Verb
dɔdɔbe	Noun
dödörö	Noun
dokpa	Adjective
dɔkpâlâ	Noun
doli	Noun
dolö	Noun
dondö	Noun
dôndô	Noun
döngbä	Noun
dɔngɔ	
dɔngɔ̈	Noun
dɔngɔ̈ngbi	Noun Verb
döpɔrɔ	Noun
dɔ̈rɔ̈	Verb
dɔrɔkɔ	Verb
dû	Noun
du	Verb
dü	Verb
dû-ngû	Noun
dû-nyɛnɛ̈	Noun
dudu	Noun
duma	Noun
düngɔ̈	Noun
dûnîa	Noun
dûru	Verb
dutï	
dutï nzɔ̈nî	Interjection
ë	
ë mvɛnî	
ere	Verb
ɛ̂rɛ̂gɛ	Noun
fâ	Noun
fä	Noun Verb
fa	Verb
fâ-nî	Noun
fâa	Verb
fadë	Adverb
fadësô	Adverb
fafadësô	Adverb
fâla	Verb
fâla mbïɔ̂	Verb
fâla zûâ	Verb
fângbi	Noun
fâra	Verb
farânzi	Noun
farïni	Noun
fên	Adverb
fɛ̂rɛ̂rɛ̂	Noun
fi	Verb
fîmbo	Noun
fingi	Noun
finî	Adjective Noun
finön	Noun
fö	Noun
fo	Noun
fɔndɔ	Noun
föndo	Noun
fɔ̈nɔ̈	Noun
fɔnɔ	Verb
fû	Verb
fü	Verb
fufû	Noun
fufulafu	Noun
fûku	Noun
fulundïngi	Noun
fûn	Noun
fün	Verb
fungâ	Noun
fûnga	Verb
füngɔ̈	
fungûla	Noun Verb
fûru	Noun Verb
fûta	Noun Verb
füu	Adjective
gä	Verb
ga-	Prefix
gagi	Noun
gana	Verb
gânda	Noun
gängä	Noun
gângârâ	Noun
gangba	Adjective
gângbi	Verb
gängɔ̈	
ganzâ	Noun
gao	Noun
gapa	Noun
garâ	Noun
gara	Verb
gasa	Noun Verb
gatï	Adverb
gbä	Adverb
gbâ	Noun Verb
gba	Verb Adverb
gba-mbîngo	Noun
gba-na-mbänä	Noun
gbadöla	Noun
gbafu	Noun
gbagä	Noun
gbägbä	Adjective Noun
gbâgbârâ	Noun
gbagbara	Verb
gbâka	Adverb
gbâkarâgba	Noun
gbakô	Noun
gbâkûrû	Noun
gbalâka	Noun
gbândä	Adverb
gbânda	Noun
gbânda tî tɛrɛ	Noun
gbânda-sango	Noun
gbängä	Noun
gbanza	Noun
gbânzi	Verb
gbanzia	Noun
gbara	Noun Verb
gbaragaza	Noun
gbârâka	Noun
gbari	Noun
gbätä	Noun
gbâzâ	Noun
gbâzâ-bängâ	Noun
gbäzägbö	Noun
gbɛ	Noun
gbë	Verb
gbɛ-lɛ̂	Noun
gbɛ-nyön-gbïâ	Noun
gbɛ̈ɛ	Verb
gbefâ	Noun
gbɛ̈nɛ̈	Noun
gbɛnɛ	Verb
gbênga	Verb
gbêngbi	Verb
gbenzï	Noun
gbɛrɛ̂	Noun
gbï	Verb
gbïâ	Noun
gbîangbi	Verb
gbigbi	Noun
gbikï	Noun
gbïngɔ̈	
gbɔ-ngû	Verb
gbɔ-tɛ	Verb
gbogbo	Noun
gbôgbôlinda	Noun
gbôkôrô	Noun
gbɔ̈ɔ	Verb
gbɔrɔ	Noun
gbɔrɔngâne	Noun
gbɔ̂tɔ	Verb
gbû	Verb
gbugburu	Noun Verb
gbuügbuü	Adverb
gɛ	Adverb
gêkôrô	Noun
gɛnɛ	Noun
genia	Adjective
gɛ̈nyɛ̈ngɔ̈	Noun
gɛrɛ̂	Noun
gɛrɛ̂-wüngɔ̈	
gɛrɛrɛ	Adjective Adverb
gɛ̈tɛ̈	Noun
gï	Adverb
gi	Verb
gi bɛ̂	Verb
gi na bɛ̂	Verb
gi-bɛ̂	Noun
gîâ	Verb
gidi	Noun
gïgî	Noun
gilisa	Verb
gindî	Noun
gïngɔ̈	
ginon	Noun
giɔ	Verb
giriri	Adverb
gɔ̂	Noun
gobi	Noun
gɔbɔ	Noun
gögö	Noun
gɔgɔrɔ	Noun
gögüâ	Noun
gɔigɔ̂î	Noun
gön	Verb
gônda	Noun Verb
gɔ̂rɔ	Noun
gôsâ	Noun
gôyongö	Noun
gɔzɔ	Noun
gua	Noun
gûâ	Verb
guagua	Adverb
güâgüâ	Noun
gue	Verb
gue nzɔ̈nî	Interjection
gügü	Noun
gügümä	Noun
gugûrû	Noun
gûî	Noun
gündâ	Noun
gürü	Noun
gûrû	Noun
hä	Verb
hâa	Verb
hâka	Verb
häkängɔ̈	
häko	Noun
hân	Verb
hânda	Noun Verb
hâriya	Noun
he	Verb
he ngîâ	Verb
hɛ̈nɛ̈	Noun
hɛnɛ	Verb
hînga	Verb
hïngängɔ̈	
hîni	Verb
hîo	Adverb
hîo-hîo	Adverb
hôn	Noun
hɔ̈n	Verb
hɔ̈n ndɔ̈ tî	Verb
hɔ̂ndɛ	Verb
hɔ̂ndɛ-sïɔ̂-yê	Verb
hɔ̈ngɔ̈	
hû	Verb
hûnda	Noun Verb
hunu	Verb
hûnzi	Verb
hürü	Noun
huru	Verb
ï	
in	Adverb
in-in	Adverb
îngɔ̈	Noun
înɔ̈	Noun
ïrï	Noun
îri	Verb
îtä	Noun
îtä-buä	Noun
ka	Conjuction
kâ	Conjuction Adverb
kä	Noun Verb
kâbî	Noun
kabinêe	Noun
kadâ	Noun
kâfe	Noun
kaga	Noun
kâî	Noun
kâi	Verb
kakâ	Noun
kakara	Adverb
kakauka	Noun
käkërë	Noun
kakö	Noun
käkorö	Noun
kalâ	Noun
kalambo	Noun
kamâta	Noun Verb
kamba	Noun
kâmba	Noun
kambirï	Adjective Noun
kambîri	Noun
kambisä	Noun
kambisa	Verb
kämbûsu	Noun
kamɛ̈nɛ̈	Noun
kanâna	Noun
kandä	Noun
kandâa	Conjuction
kângâ	Noun
kânga	Noun Verb
kangamä	Noun
kangba	Adjective Noun
kängbä	Noun
kângbâ	Noun
kângbi	Noun Verb
kangi	Noun
kängɔ̈	
kangoya	Noun
kânyâ	Noun
kanza	Noun
kanzagɔ̈	Noun
kapï	Noun
kapitäni	Noun
kârâ	Adjective
kara	Verb
kâra	Verb
karagba	Noun
kârâgɔrɔ̈	Noun
kârâkö	Noun
karangbâ	Noun
kâsa	Noun
kasakasa	Noun
kasï	Conjuction
katɛ	Noun
katikâti	Noun
kätîsima	Noun
kâwa	Noun
kawoya	Noun
kayë	Noun
kayëe	Noun
kɛ	Verb
kɛ̈kɛ̈	Noun
kɛkɛrɛ	Noun
kêkerêke	Noun
kêlê	Verb
kɛ̂lɛ̂lɛ̂	Noun
kêma	Noun
kɛmbɛ	Noun
kênda	Noun
kɛ̈nɛ̈	Noun
kɛ̂nɛ	Verb
kɛ̈ngɛ̈	Noun
kengêre	Noun
kɛ̈ngɔ̈	
kepaka	Noun
kepakara	Noun
kɛ̂rɛ̈	Noun
kerebende	Adjective Noun
kerekpä	Noun
kerekpa	Noun
kɛ̂tɛ̂	Adjective Noun Adverb
kɛ̂tɛ̂-babâ	Noun
kɛ̂tɛ̂-ïtä	Noun
kɛ̂tɛ̂-mamâ	Noun
kî	Noun Verb
kîki	Verb
kinda	Verb
kindânda	Noun
kindë	Noun
kîndɛ̂rɛ̂	Verb
kinîni	Noun
kîɔ	Verb
kîri	Verb
kîrîkiri	Noun Adverb
kïrïngɔ̈	
kîrɔ̂	Noun
kisɔrɔ	Noun
kîtɛ	Noun
kîti	Noun
kîzi	Noun
kö	Noun Verb
kɔ̂	Verb
kô	Verb
kɔ̂-	Prefix
kɔ̂-li-tï	Noun
kɔ̂bɛ	Noun
kobêla	Noun
kobêla tî wâ	Noun
kɔdɛ̈	Adjective
kɔdɛ̈-	Prefix
kɔ̈dɔ̈rɔ̈	Noun
kɔ̈dɔ̈rɔ̈-sêse	Noun
kɔ̈garä	Noun
kɔï	Adjective Noun Adverb
kôkâ	Noun
kôko	Noun
kɔkɔ	Noun
kɔ̂kɔ̂	Noun
kɔkɔmbɛ	Noun
kɔkɔra	Noun
kɔ̂lï	Noun
koli	Noun
kɔ̂lï-	Prefix
kɔ̂lï-kɔ̂lï	Noun
kɔ̂lï-wâlï	Noun
kolîngo	Noun
kôlo	Noun
kolôfîa	Noun
kɔ̂lɔ̈kɔ̂tɔ̈	Noun
kɔlɔngɔ	Noun
kolôngo	Noun
kömbë	Adjective Noun
kɔmberëe	Noun
kombûka	Noun Verb
kɔmɛ	Noun
kɔ̂ndɔ	Noun
kongä	Noun
konga	Verb
kongba	Noun
kɔ̈ngɔ̈	
kôngô	Noun
köngɔ̈	Noun
kongɔ̈	Noun
kɔngɔ̈	Noun
kɔnɔ̂	Noun
kɔnɔ	Verb
kɔ̈nɔ̈ngɔ̈	
konza	Noun
kɔnzɔ̈ngɔ̈rɔ̈	Noun
kɔ̈pɔ̈	Noun
kopo	Noun
kɔ̈rɔ̈	Noun
kôro	Verb
kɔrɔ	Verb
korobö	Noun
korôkongbô	Noun
körömëngë	Noun
korôro	Noun
kosâra	Noun
kɔ̈sï	Noun
kɔsɔ	Noun
kɔ̂sɔ̈	Noun
kɔ̂sɔ	Verb
kɔsɔ tî ngonda	Noun
kötä	Adjective Noun
kötä ngû	Noun
kötä-babâ	Noun
kötä-bɛ̈	Noun
kötä-buä	Noun
kötä-ïtä	Noun
kötä-mamâ	Noun
kötä-zo	Noun
kötarä	Noun
kɔ̈tï	Adverb
kôto	Noun
koto	Noun
kɔtɔ	Noun Verb
kɔtɔ̈ɔn	Noun
kôya	Noun
kɔ̂zɔ	Adjective Noun
kɔ̂zɔ tî	Preposition
kɔ̂zɔnî	Adverb
kpâ	Noun
kpa	Verb
kpâa	Noun Adverb
kpaka	Verb
kpaka-ta	Noun
kpäkpä	Noun
kpâlâköngö	Noun
kpälë	Noun
kpängäbä	Noun
kpangba	Noun
kpângbârâ	Adjective
kpangbara	Adjective Noun
kpängbärä	Noun
kpângi	Noun
kpätä	Noun
kpë	Noun
kpɛ̂	Noun
kpɛ̈	Verb
kpɛ̈ mbɛtɔ	Noun
kpë-li	Noun
kpêe	Verb
kpenda	Verb
kpëngbä	Adjective
kpëngba	Verb
kpëngbängɔ̈	
kpɛ̈ngbɛ̈rɛ̈	Noun
kpere	Noun
kpɛrɛkpɛrɛ	Adverb
kpɛtɛ	Noun
kpîkara	Noun
kpɔ̂	Adjective
kpɔ	Verb
kpöka	Noun
kpôkpô	Noun
kpɔrɔ	Verb
kpɔtɔ	Noun
kpu	Noun
kpû	Noun
kpû-kângbi	Noun
kpû-tɛ̂ngbi	Noun
kpûkpû	Noun
kpûkû	Noun
kpütä	Noun
ku	Verb
kü	Verb
kûâ	Noun
küâ	Noun
kua	Noun
kualë	Noun
kûɛ̂	Adjective Adverb
kugbë	Noun
kûîi	Noun Verb
kûku	Noun Verb
kûkulû	Noun
kûkürû	Noun
kükürü	Noun
kulü	Noun
kûma	Noun
kundâ	Noun
kunda	Verb
kundi	Noun
kûngbâ	Noun
kûngbi	Noun Verb
kûngü	Noun
kupu	Noun
kürä	Noun
kürü	Adjective
kûrûkürü	Noun
kürüngü	Noun
kusâra	Noun
kûtu	Adjective Noun
kûtu-	Prefix
kûtu-gɛrɛ̈	Noun
kutukutu	Noun
kuzü	Noun
lâ	Noun
lâ wa	Suffix
lâ-kûî	Noun
lâ-nî	Adverb
lâ-nî-sô	Adverb
lâ-pɔ̂sɔ	Noun
lâ-sô	Adverb
lâ-wa	Adverb
lâ-yenga	Noun
laä	
lâbâdâ	Noun
lägbädä	Noun
lâi	Noun
lakërë	Noun
lakpängbä	Adjective
lâkûɛ̂	Adverb
lâkûɛ̂-lâkûɛ̂	Adverb
lâmbâ	Adjective
lando	Noun
langä	Noun
längɔ̈	Noun Verb
lapärä	Noun
lavu	Noun
lawü	Noun
lê	Noun
lɛ̂	Noun
lë	Verb
lɛ̂-tî-bëkpä	Noun
lê-yäkä	Noun
lêgë	Noun
lêgë-ɔ̈kɔ	Adverb
lɛkɛ	Verb
lɛkɛrɛ	Verb
lekpa	Noun
lëlë	Noun
lele	Noun
lɛlɛ	Noun
lêlê	Noun
lembe	Noun
lëndâ	Noun
lendë	Noun
lêngbêtɔ̂rɔ̂	Noun
lenge	Noun
lɛ̂ngua	Noun
li	Noun
lï	Verb
li tî tûrûngu	Noun
li-kûnɛ	Noun
li-ngû	Noun
li-tɛ̈nɛ̈	Noun
li-tï	Noun
lîâ	Noun
lîfïlo	Noun
likisi	Noun
likɔngɔ̂	Noun
likundû	Noun
linda	Verb
lïngä	Noun
lîngbi	Verb
lïngɔ̈	
lîɔ	Adjective
lisoro	Noun
lo	
lö	Noun
lo mvɛnî	
lö-bîâ	Noun
lö-gbïâ	Noun
lö-kûtu	Noun
lö-ndâ	Noun
lɔkpɔtɔ	Noun
lolo	Noun
lɔ̈mbɔ̈	Noun
löndö	Verb
löndö na	Verb
lɔngɔ	Noun
lɔ̈rɔ̈	Noun
lɔ̂sɔ	Noun
lü	Verb
lûku	Verb
lungûla	Verb
lûpa	Noun
lütï	Verb
ma	
mä	Verb
ma bɛ̂	Verb
mä na bɛ̂	Verb
mä ndâ	Verb
ma-bɛ̂	Noun
mä-na-bɛ̂	Noun
mä-ndo	Interjection
mä-yângâ	Noun
mabaya	Noun
mabɔ̂kɔ	Noun
mafüta	Noun
mafüta tî mbûrü	Noun
mafüta tî ngû tî mɛ tî bâgara	Noun
mafüta tî wɔ̂tɔrɔ	Noun
magbɔ̈ngä	Noun
magia	Noun
makâko	Noun
makala	Noun
makângo	Noun
makelâ	Noun
makobe	Noun
makongö	Noun
makoröo	Noun
malangi	Noun
malînga	Noun
mamâ	Noun
mamâ tî mâpa	Noun
mamîwätä	Noun
manda	Verb
mandako	Noun
mändängɔ̈	
mânga	Noun
mangbɛ̂rɛ̂	Noun
mângbi	Noun Verb
mangbökö	Noun
mângo	Noun
manzêke	Noun
manzinzi	Noun
mâpa	Noun
mapîâ	Noun
mapô	Noun
märä	Adjective
marä	Noun
masango	Noun
mâsarâgba	Noun
maseka	Noun
maseka tî kɔ̂lï	Noun
maseka tî wâlï	Noun
masïni	Noun
masua	Noun
matabïsi	Noun
matânga	Noun
mawa	Noun
mawôya	Noun
mayɛ̈rɛ	Noun
mbâ	Noun
mbadi	Noun
mbâgë	Noun
mbâgë tî kɔ̂lï	Noun
mbâgë tî wâlï	Noun
mbâkêlê	Noun
mbäkɔ̂rɔ	Adjective Noun
mbala	Noun
mbamba	Noun
mbänä	Noun
mbängü	Noun
mbanu	Noun
mbârâmbârâ	Adjective
mbârâtâ	Noun
mbârâwârâ	Noun
mbâsa	Noun
mbâsala	Noun
mbâsâmbârâ	Adjective
mbätä	Noun
mbata	Noun
mbɛ̂â	Noun
mbɛ̈ngɛ̈	Noun
mbɛ̂nî	Adjective Noun Adverb
mbɛ̂nî äpɛ	Adverb
mbɛ̂nî pɛ̈pɛ	Adverb
mbɛ̂nî-bîrï	Adverb
mbɛ̂nî-kêkerêke	Adverb
mbɛ̂nî-lâ	Adverb
mbere	Noun
mbɛ̂rɛ̂kɛ̂	Noun
mbeso	Adverb
mbɛ̈tï	Noun
mbɛ̈tï tî nzapä	Noun
mbɛ̈tï-kua	Noun
mbɛ̈tï-lêgë	Noun
mbɛ̈tï-sango	Noun
mbɛ̈tï-tokua	Noun
mbɛtɔ	Noun
mbï	
mbï mvɛnî	
mbîndä	Noun
mbîngo	Noun
mbïɔ̂	Noun
mbîrîmbîrî	Adjective Adverb
mbö	Noun
mbo	Noun
mbô	Verb
mbôko	Verb
mbôko-li	Adjective
mbɔ̈kɔ̂rɔ	Adjective
mbômbô	Adjective
mbômbô-li	Noun
mbɔ̂ngɔ	Noun
mbongo	Noun
mborô	Noun
mbôrôrô	Noun
mbɔtɔ̈	Noun
mbûki	Noun
mbuma	Noun
mbunzû	Noun
mbunzû-nzapä	Noun
mbunzû-vukɔ̈	Noun
mbûrü	Noun
mburu	Noun
mburu-wâ	Noun
mbütü	Noun
mɛ	Noun Verb
mɛ̂	Noun Verb
mêa	Noun
mɛɛ̈	Conjuction
mɛka	Noun Verb
mɛ̂nɛ̈	Noun
mɛnɛ	Verb
mɛ̈ngä	Noun
mɛ̈ngɔ̈	Noun
mɛ̂sa	Noun
mɛtï	Verb
mî	Noun
mî-suïya	Noun
mî-tɛrɛ̂	Noun
mîmi	Adjective
mîngi	Adjective Adverb
mîngɔ	Verb
miɔmbe	Adjective
mɔ	
mɔ mvɛnî	
mɔ-bâa-mɔ-tɛnɛ	Conjuction
mɔbangë	Noun
mɔdɔ̈gɛrɛ̂	Noun
mɔkiri	Noun
mɔkondö	Adjective Noun
mokönzi	Noun
môlɛngê	Noun
môlɛngê tî kɔ̂lï	Noun
môlɛngê tî ndeko	Noun
môlɛngê tî wâlï	Noun
molongö	Noun
mondelepâko	Noun
mongânga	Noun
möngö-li	Noun
mopɛpɛ	Noun
mɔpï	Noun
mɔsasako	Noun
mosongôli	Noun
mɔsɔrɔ	Noun
mosümä	Noun
mɔzïngɔ̈	Noun
mû	Verb
mû kɔ̂lï	Verb
mû lêgë	Verb
mû lêgë na	Verb
mû mabɔ̂kɔ na	Verb
mû na mbï	Verb
mû ngîâ na bɛ̂ tî	Verb
mû wâ	Verb
mû wâlï	Verb
mû wängɔ̈	Verb
mû wängɔ̈ na	Verb
mû yângâ tî	Verb
müâ	Noun
muen	Noun
mûlu	Noun
mûngbi	Noun Verb
mûrû	Noun
mvɛlɛ	Noun
mvɛnɛ	Noun Interjection
mvɛnî	Noun
mvüka	Noun
na	Conjuction Preposition
na mbâgë wa	Suffix
na ndo wa	Suffix
nabändurü	Noun
ndâ	Noun
ndâ-gɛrɛ̂	Noun
ndâ-li	Noun
ndâ-li tî	Preposition
ndâ-li tî nyen	Adverb
ndâ-li tî sô	Conjuction Adverb
ndâ-lö	Noun
ndâmbo	Noun
ndângbâ	Noun
ndângbâ-li-tï	Noun
ndao	Noun
ndäpêrê	Noun
ndäpêrêrê	Noun
ndarä	Noun
ndârâ	Noun
ndaramba	Noun
ndatu	Noun
ndaü	Noun
ndê	Adjective Adverb
ndê-ndê	Adjective Adverb
ndɛkɛ	Noun
ndeko	Noun
ndeko-zändë	Noun
ndembë	Noun
ndembö	Noun
ndiba	Noun
ndikâ	Noun
ndindïâ	Noun
ndïrï	Noun
ndô	Noun
ndö	Noun
ndo	Noun
ndö-lɛ̂	Noun
ndö-nî	Noun
ndö-tî	Noun
ndo-wâ	Noun
ndö-yê	Noun Verb
ndö-yëngɔ̈	Noun Verb
ndoï	Noun
ndɔ̈kɔ̈	Noun
ndɔkɔ̂rɔ̈	Noun
ndɔmbɛ	Noun
ndɔmbɔ̈	Noun
ndôngô	Noun
ndôo	Verb
ndü	Noun
ndû	Verb
ndûmba	Noun
ndurü	Adjective
ndûrûkpâ	Adjective
ndütü	Noun
ndüzü	Noun
nɛ	Verb
nɛka	Verb
nɛ̈ngɔ̈	
ngâ	Adverb
ngä	Noun
ngâäkôo	Noun
ngâgö	Noun
ngambi	Noun
ngän	Noun
ngängä	Noun
nganga	Noun
ngango	Noun
ngangü	Adjective Noun Adverb
ngâo	Noun
ngâpô	Noun
ngäsa	Noun
ngâsî	Noun
ngbä	Noun
ngbâ	Verb
ngbâ nzɔ̈nî	Interjection
ngbâ-kongö	Noun
ngbâa	Verb
ngbadârâ	Noun
ngbâko	Noun
ngbâlo	Noun
ngbänbɔ̈	
ngbanga	Noun
ngbanga tî	Preposition
ngbanga tî nyen	Adverb
ngbanga tî sô	Conjuction Adverb
ngbângbä	Noun
ngbängbâ	Noun
ngbangbo	Adjective
ngbangbo-	Prefix
ngbangbo-tukîa	Noun
ngbângêrêngû	Noun
ngbɛ̂nɛ	Adjective
ngbëngbë	Noun
ngbengë	Noun
ngbêrênâ	Noun
ngbɛtɛrɛ	Noun
ngbii	Adverb
ngbii asî na	Preposition
ngbii sï	Conjuction
ngbɔ̈	Noun
ngbɔ̈kɔ̈	Noun
ngbondä	Noun
ngbondô	Adjective
ngbonga	Noun
ngbongbôro	Adjective
ngbɔ̂ngbɔ̈rɔ̈	Noun
ngbongboto	Noun
ngbɔ̂ngɔ̂	Noun
ngbôto	Noun
ngbûku	Noun
ngbundangbu	Adjective
ngbundangbu-	Prefix
ngbungbu	Noun
ngbuta	Noun
ngɛ	Noun Verb
ngɛndɛ̈	Noun
ngenge	Noun
ngɛ̈ngɔ̈	Verb
ngêrë	Noun
ngîâ	Noun
ngiba	Noun
ngïdïkï	Noun
nginza	Noun
ngira	Noun
ngiriba	Noun
ngɔ̈	Noun
ngo	Noun
ngɔ	Noun
ngô	Verb
ngo-tï	Noun
ngoi	Noun
ngoi tî burü	Noun
ngoi tî ngû	Noun
ngɔ̂lɔ̈	Noun
ngɔ̈lɔ	Noun
ngombe	Noun
ngonda	Noun
ngonga	Noun
ngôngbi	Noun Verb
ngonzâ	Noun
ngɔnzɔ	Noun
ngɔrɔ	Noun
ngoro	Verb
ngôrôngbi	Verb
ngöröngbö	Verb
ngoropangi	Noun
ngû	Noun
ngû tî kɔ̂lï	Noun
ngû tî lɛ̂	Noun
ngû tî mbɛ̈tï	Noun
ngû tî mɛ	Noun
ngû tî mɛ tî bâgara	Noun
ngû tî nyön	Noun
ngû tî nzapä	Noun
ngû tî tɛrɛ̂	Noun
ngû tî vurü	Noun
ngû tî yängâ	Noun
ngû-lavu	Noun
ngû-lɛ̂	Noun
ngû-ngunzä	Adjective
ngû-nzapä	Noun
ngû-yenga	Noun
nguba	Noun
ngubë	Noun
ngubü	Noun
ngui	Noun
ngûmbâ	Noun
ngümbâyä	Adjective
ngundë	Noun
ngungu	Noun
ngunzä	Noun
ngûru	Noun
ngusü	Noun
nï	
nî	
nîgisi	Noun
nika	Verb
nïkpä	Noun
nînga	Verb
nô	Noun
nö	Verb
nyama	Noun
nyâu	Noun
nyen	Noun
nyɛnɛ̈	Noun
nyengo	Noun
nyɛnyɛ	Noun
nyɛnyɛkɛ̂	Adverb
nyï	Noun
nyï-kɛ̂lï	Noun
nyï-li-tï	Noun
nyï-ndü	Noun
nyï-ngambi	Noun
nyï-wâlï	Noun
nyï-wanda	Noun
nyɔ̈n	Verb
nyɔ̈n mânga	Verb
nyɔ̈n mɛ̂nɛ̈	Verb
nzä	Noun
nza	Noun
nzabï	Noun
nzaï	Noun
nzângi	Noun
nzanza	Noun
nzanzë	Noun
nzapä	Noun Interjection
nzapä-babâ	Noun
nzara	Noun
nzara tî ngû	Noun
nzayü	Noun
nzɛ	Noun
nzɛ balë-ɔ̈kɔ	Noun
nzɛ balë-ɔ̈kɔ na ɔ̈kɔ	Noun
nzɛ balë-ɔ̈kɔ na üse	Noun
nzɛ mbârâmbârâ	Noun
nzɛ miɔmbe	Noun
nzɛ ngümbâyä	Noun
nzɛ ɔ̈kɔ	Noun
nzɛ ɔkü	Noun
nzɛ omɛnë	Noun
nzɛ otâ	Noun
nzɛ üse	Noun
nzɛ üsïô	Noun
nzêen	Verb
nzêen na pekö tî	Verb
nzëgë	Noun
nzɛli	Noun
nzɛ̂nɛ	Adjective
nzɛ̈nɛ̈	Noun
nzɛnzɛ	Noun
nzêpêrê	Noun
nzerë	Noun
nzɛrɛ	Verb
nzɛrɛ na bɛ̂ tî	Verb
nzerë tî ndüzü	Noun
nzɛ̈rɛ̈ngɔ̈	Adjective
nzï	Verb
nzîna-	Prefix
nzîna-ngonga	Noun
nzïngɔ̈	
nzɔ̈	Noun
nzɔ̈-	Prefix
nzɔ̈-bä	Noun
nzɔ̈-bê	Noun
nzɔ̈-bîâ	Noun
nzɔ̈-dëbä	Noun
nzɔ̈-sango	Noun
nzɔmbɔ̈	Noun
nzɔ̈ngɔ̈rɔ̈	Noun
nzɔ̈nî	Adjective Noun Adverb
nzɔ̈nî-sango	Noun
nzɔrɔ̂kɔ	Adjective Noun
nzɔrɔ̂kɔ kömbë	Adjective
o	
ɔ̂kɛ	Adverb
ɔ̂kɔ	Adjective
ɔ̂kɔ äpɛ	Adjective Adverb
ɔ̂kɔ pɛ̈pɛ	Adjective Adverb
ɔ̂kɔ-ɔ̈kɔ	Adjective
ɔkü	Adjective
ömba	Noun
omɛnë	Adjective
otâ	Adjective
ɔ̂tɔ̈	Noun
pâ	Noun
pä	Verb
pä ïrï tî	Verb
pakapâka	Noun
pakara	Noun
pambo	Noun
pâmbo-tï	Noun
pandë	Noun
pängä	Noun
papa	Noun
pâpâ	Noun
papayë	Noun
pärä	Noun
pärä-gɛrɛ̈	Noun
pärä-tï	Noun
päsä	Noun
päsäpɔ̂rɔ	Noun
pasëe	Verb
pâsi	Noun
pastɛ̈rɛ	Noun
patâ	Adjective
pâta	Noun
patärä	Noun
pe	Verb
pɛ̈	Verb
pɛkɛ̈	Noun
pekö	Noun
pɛ̈mbɛ̈	Noun
pendä	Noun
pɛndɛrɛ	Adjective
pɛndɛrɛ kɔ̂lï	Noun
pɛndɛrɛ wâlï	Noun
pɛ̈ngɔ̈	Verb
pɛnzɛ	Noun
pɛ̈pɛ	
pêrë	Noun
pɛ̈tɛ̈	Noun
pɛ̂tɛ	Noun
pɛtɛ	Verb
pîda	Verb
pîka	Verb
pîka mabɔ̂kɔ	Verb
pîka mbɛ̈tï	Verb
pîka ndembö	Noun
pîka ngombe	Noun
pîka ngû	Noun
pîka patärä	Noun
pîka wên	Noun
pîka-hôn	Verb
pîka-ngâsî	Verb
pilipîli	Noun
pïndïrï	Noun
pïndïrï tî wâ	Noun
pîpï	Noun
pîri	Noun
pito	Noun
plâta	Noun
polêlê	Adverb
polîsi	Noun
pɔ̈mɛ̈	Noun
pɔ̂me-sitɛ̈rɛ	Noun
pɔ̈mɛ̈tɛ̂rɛ	Noun
pɔ̈ngï	Noun
pɔngi	Verb
pɔnɔ̈	Noun
popö	Noun
popô	Noun
pöpö	Noun
pöpö-	Prefix
pôpôrô	Noun
pɔ̈rɔ̈	Noun
pɔ̈rɔ̈ tî gɛrɛ̂	Noun
pɔ̈rɔ̈ tî kɛ̈kɛ̈	Noun
pɔ̈rɔ̈ tî mabɔ̂kɔ	Noun
pɔ̈rɔ̈-lɛ̈	Noun
pɔ̈rɔ̈-yângâ	Noun
pɔtɔ	Verb
pɔtɔpɔ̂tɔ	Noun
pulûsu	Noun
pupu	Noun
pupu-sêse	Noun
pûpûlɛngɛ	Noun
purû	Noun
purû tî ngû	Noun
pûsu	Verb
pûsu-pûsu	Noun
sâa	Noun Verb
sâa pendä	Verb
sâa to	Verb
sâa-kilöo	Noun
sâa-ngonga	Noun
sâa-pɛ̈tɛ̈	Noun
sâa-wâ	Noun
saba	Noun
sägbä	Noun
sâi	Noun
sâki	Adjective
sâki-	Prefix
sakpä	Noun
saläad	Noun
sambâ	Noun
sâmba	Noun
sâmba tî bengbä	Noun
sâmba tî vurü	Noun
sambêla	Noun Verb
sândâga	Noun
sandûgu	Noun
sangbi	Noun Verb
sangbi-lêgë	Noun
sangbi-wâ	Noun
sängï	Noun
sängï bulɛ̂ɛ	Noun
sängï fɔndɔ	Noun
sango	Noun
sängɔ̈	Noun
sântînî	Noun
sanze	Noun
sânzîrî	Noun
sâra	Verb
sâra nâ	Verb
sâra nâ bɛ̂ ɔ̈kɔ	Verb
sâra nâ bɛ̂ üse	Verb
sâra yângâ	Verb
sarawîsi	Noun
sasa	Verb
sê	Verb
sɛ̈ tî kä	Noun
sɛ̂-	Prefix
seko	Noun
sɛmbɛ̈	Noun
sɛ̂ndâ	Noun
sɛ̂ndâ-	Prefix
sɛ̈ndɛ̈	Noun
sɛ̈nɛ̈	Noun
sɛ̂ngɛ̂	Adjective Adverb
sɛpɛ̈	Noun
sɛpɛla	Verb
sɛ̈pɛ̈längɔ̈-zo	Noun
serê	Noun
sêse	Noun
sesêe	Adjective
sêtâ	Noun
sɛ̈tɛ̈	Noun
sêwâ	Noun
sï	Conjuction Verb Adverb
sî	Verb
sî gîgî	Verb
sî na	Verb
sï-zuka	Verb
sîgî	Verb
sîgîgî	Verb
simîsi	Noun
sindi	Noun
sînga	Noun
sîngâ	Noun
singi	Noun
singîla	Noun Verb Interjection
sïngɔ̈	
sïngɔ̈-lâ	Noun
sïɔ̂-	Prefix
sïɔ̂-bä	Noun
sïɔ̂-dëbä	Noun
sïɔ̂-kpälë	Noun
sïɔ̂-kpärï	Noun
sïɔ̂-yê	Noun
sïɔ̂-zo	Noun
sïɔ̂nî	Adjective Noun Adverb
sïɔ̂nî pêrë	Noun
siri	Noun
sîrîrî	Noun Adverb
sisa	Noun
sisi	Noun
sô	Conjuction Verb
so	Verb
sô mo yê	
sô mvɛnî sï	
sombêe	Verb
sombere	Noun
sôn	Noun Verb
sɔngɔ̈	
söngö	Noun
sɔngɔ̈-bɛ̂	
songosongo	Noun
sɔ̈rɔ̈	Noun
sorö	Noun
soro	Verb
soronga	Verb
sɔsɔ	Noun
sösö	Noun
sü	Verb
su	Verb
sü-mbɛ̈tï	Verb
sûâ	Noun
sua	Verb
sûî-	Prefix
suïya	Noun
sukâni	Noun
sûku	Verb
sukûla	Verb
sukûla bɛ̂	Verb
sukûla ngû	Verb
sükülängɔ̈ ngû	Noun
sukûlu	Noun
sulëe	Verb
sümä	Noun
suma	Verb
suma süma	Verb
sumbu	Noun
sungbä	Noun
sungba	Verb
süngbängɔ̈	Noun
süngɔ̈-mbɛ̈tï	
sûpu	Noun
surä	Noun
sura	Verb
sûru	Verb
susu	Noun
ta	Noun
tä-	Prefix
ta-kâsa	Noun
tâ-li-tï	Noun
tâ-ngbɔ̈	Noun
ta-ngû	Noun
ta-sêse	Noun
taä	Adjective
taä-pandë	Noun
taä-sängɔ̈	Noun
taä-tɛnɛ	Noun
taba	Noun
tâgba	Noun
tâkâ-	Prefix
tambûla	Noun Verb
tanga	Noun
tangë	Noun
tângo	Noun
täpärë	Noun
tarä	Noun
tara	Verb
tatalîta	Noun
tatärä	Noun
tatara ndo	Noun
tatärä-lɛ̂	Noun
taza	Noun
tɛ	Verb
tɛ-kîri	Noun
tɛ-lötï	Noun
tembe	Noun
tende	Noun
tɛ̈nɛ̈	Noun
tɛ̂nɛ̈	Noun
tɛnɛ	Verb
tɛnɛ mvɛnɛ	Verb
tɛnɛ taä-tɛnɛ	Verb
tɛnɛ tɛ̈nɛ̈	Verb
tɛ̈nɛ̈ tî	Preposition
tɛ̈nɛ̈ tî nyen	Adverb
tɛ̈nɛ̈ tî nzapä	Noun
tɛ̈nɛ̈ tî sô	Conjuction Adverb
tɛ̈nɛ̈ngɔ̈ tɛ̈nɛ̈	Verb
tɛ̂nga	Verb
tɛ̂nga-wâ	Noun
tɛ̂ngbi	Noun Verb
tɛrɛ	Noun
tɛrɛ̂	Noun
tï	Noun Verb
tî	Preposition
tî tɛnɛ	Conjuction
tî-ndâ-nî	Adverb
tîâa	Verb
tikî	Noun
tikîsa	Verb
tîkɔ̈	Noun
tîkɔ	Verb
tipôi	Noun
tiri	Verb
tirika	Verb
tîrîngbi	Verb
tɔ̈	Noun
tö	Verb
to	Verb
tö-	Prefix
tö-buä	Noun
to-kua	Verb
tö-li-tï	Noun
tô-ngbɔ̈	Noun
tokua	Noun
toli	Noun
tôlo	Noun
tomâti	Noun
tombôka	Verb
töndâ	Verb
töndö	Noun
tɔndɔ	Verb
tɔ̈ndɔ̈ngɔ̈	
tonga	Noun
töngana	Conjuction Preposition
töngana nyen	Adverb
töngana tî sô	Conjuction
töngasô	Conjuction Adverb
tôngbï	Noun
tôngbi	Verb
tɔ̈ngɔ̈	
töngɔ̈	
tongo	Noun
tongoro	Noun
tɔnɔ	Verb
tɔ̂ɔ	Verb
tɔrɔ̂rɔ̂	Adverb
tɔtɔ	Noun
toto	Noun Verb
tukîa	Noun
tûku	Noun Verb
tûku môlɛngê	Verb
tumba	Noun Verb
tungu	Noun
turu	Noun
turûgu	Noun
tûrûngu	Noun
tutü	Verb
ülë	Noun
ûlɛ	Verb
ülɛ̈ngɔ̈	Adjective
ûru	Verb
uru	Verb
ûrûlû	Noun
ûse	Adjective
üsïô	Adjective
va	Noun
vaka	Noun
vârä	Noun
vâtândâ	Adverb
vɛkɛ̈	Noun
vîi	Adverb
vo	Verb
vɔ	Verb
vɔ ngêrë	Verb
vɔ to 	Verb
vɔ vɔ̈ngɔ̈ 	Verb
vongbâ	Noun
vɔ̈ngɔ̈	
vɔrɔ	Verb
vɔrɔ tɛrɛ̂	Verb
vɔ̈rɔ̈ngɔ̈	
vɔvɔrɔ	Noun
vü	Verb
vukɔ̈	Adjective
vûkɔ̈	Verb
vûkɔ̈ kɛ̂tɛ̂	Verb
vukɔ̈ mbunzû	Noun
vûkɔ̈ mîngi	Verb
vukɔ̈-kɛ̂tɛ̂	Adjective
vûkɔ-lɛ̈	Noun
vukɔ̈-vukɔ̈	Adjective
vümä	Noun
vundû	Noun
vurü	Adjective Noun
vuru	Verb
vuru kɛ̂tɛ̂	Verb
vuru mîngi	Verb
vurü-kɛ̂tɛ̂	Adjective
vurü-vurü	Adjective
wâ	Noun
wa	Noun Verb Suffix
wa-	Prefix
wa-bɛ̂	Verb
wa-fängɔ̈-kûâ	Noun
wa-fängɔ̈-mbɛ̈tï	Noun
wa-fängɔ̈-yê	Noun
wa-hânda	Noun
wa-mä-bɛ̂	Noun
wa-mändängɔ̈-kûâ	Noun
wa-mändängɔ̈-mbɛ̈tï	Noun
wa-mändängɔ̈-yê	Noun
wa-ndê	Noun
wa-nzï	Noun
wa-polîsi	Noun
wa-pulûsu	Noun
wa-sɛ̂ndâ	Noun
wa-süngɔ̈-mbɛ̈tï	
wa-tokua	Noun
wa-turu	Noun
wa-yângâ-nzapä	Noun
wa-zibä	Noun
waäwa	Adjective Adverb
wala	Conjuction
wâlï	Noun
wâlï-	Prefix
wâlï-kɔ̂lï	Noun
wâlï-wâlï	Noun
wängɔ̈	
wängɔ̈-bɛ̂	
wara	Verb
wätäkä	Noun
wên	Noun
wërë	Noun
wɛ̂rɛ	Verb
wɛ̈rɛ̈ngɔ̈	Adjective
wɔ	Verb
wö	Verb
wɔ bɛ̂	Verb
wɔ tɛrɛ̂	Verb
wɔ̂garä	Noun
wôko	Verb
wököngɔ̈	
wɔ̈rɔ̈	Noun
wɔ̂tɔrɔ	Noun
woza	Verb
wü	Verb
wûku	Verb
wüngɔ̈	
wûrûwûrû	Noun
wûsûwusu	Adverb
wûyâwuya	Noun
ya	Noun
yä	Noun
yäkä	Noun
yakepaka	Noun
yakɛ̂rɛ̂-	Prefix
yakɛ̂rɛ̂-ngonga	Noun
yändä	Noun
yângâ	Noun
yângâ-da	Noun
yangba	Noun
yangö	Noun
yapakara	Noun
yapü	Adjective Noun
yâpu	Verb
yäsï	Noun
yäyû	Noun
yazo	Noun
yɛ	Noun
yê	Noun Verb
yê-daä	Verb
yɛkɛ	Verb Adverb
yɛkɛ na	Verb
yɛkɛ tî	Verb
yɛkɛ-yɛkɛ	Adverb
yêkpâ	Noun
yême	Noun
yenga	Noun
yênge	Verb
yëngëngɔ̈-sêse	
yɛ̈ngɛ̈rɛ̈	Noun
yɛngɛrɛ	Verb
yëngɔ̈-daä	
yëngɔ̈-ndö	Noun Verb
yɛ̈rɛ̈	Noun
yîkɔ	Verb
yingɔ̈	Noun
yingɔ̈-gbïâ	Noun
yingɔ̈-va	Noun
yingɔ̈-vurü	Noun
yɔ	Verb
yɔ̂	Verb
yɔ̈mbɔ̈	Noun
yongba	Noun
yɔngɔ̂rɔ	Adjective
yɔrɔ̈	Noun
yɔ̂rɔ	Verb
yɔ̈rɔ̈ngɔ̈	Adjective
yü	Verb
yûru	Verb
yuru	Verb
zä	Verb
zâbolo	Noun
zâkâri	Verb
zakarima	Verb
zâkâzaka	Adverb
zalamäa	Noun
zambala	Noun
zängɔ̈	
zaza	Noun
zɛ	Noun
zêe	Verb
zɛgbɛ-	Prefix
zɛgbɛ-ngonga	Noun
zegë	Noun
zɛmbɛ	Noun
zɛmɛ	Noun
zën	Noun Verb
zëngɔ̈ ndo	
zî	Verb
zï	Verb
zî bɔngɔ̈	Verb
zî-bɔngɔ̈	Verb
zîâ	Verb
zîâ bɛ̂	Verb
zîâ kɔ̂lï	Verb
zîâ lêgë na	Verb
zîâ na bɛ̂	Verb
zîâ na ndö	Verb
zîâ ngîâ na bɛ̂ tî	Verb
zîâ ngû	Verb
zîâ wâlï	Verb
zîâ yângâ	Verb
zîâ-bɛ̂	Noun
zïângɔ̈	
zibä	Noun
zîdɔrɔ	Noun
zigidâ	Noun
zîngɔ	Verb
zîngɔ na	Verb
zo	Noun
zɔ̈	Verb
zo kûɛ̂ zo	
zo tî nzï	Noun
zo wa	Suffix
zɔ̈ wâ	Verb
zonga	Noun Verb
zɔ̈ngɔ̈	Adjective
zöngö	Noun
zû	Verb
zûâ	Noun
züngɔ̈	
