âatene	Noun
abonëe	Noun
abonêe	Verb
abonemäa	Noun
aderêsi	Adjective
âdu	Preposition
afëre	Noun
afrîka	Adjective
Afrîka	Noun
agârâwo	Noun
agîngî	Noun
agü	Noun
ahön	Adjective
âkese	Noun
äkïlösëtôme	Verb
âkôgarä	Noun
âkögarä	Noun
âkötarä	Noun
âla	Pronoun
alë	Noun
älëkôle	Noun
älëzêbere	Noun
Alizerîi	Noun
Âllah	Adjective
alüu	Noun
âmbênî	Adverb
ambëtï	Noun
ambiâsi	Noun
ambïi	Noun
ambilâsi	Noun
amerekanïi	Noun
Amerîka	Noun
âmîbe	Adverb Noun
amidöon	Adverb Noun
âmokönzi	Adjective Noun
amplïi	Noun
ampûle	Noun
anfûla	Verb Noun
angara	Adverb Adjective
ângbö	Verb Noun
ângbö-okü	Verb Noun
ânge	Adjective Noun Interjection
angêre	Adverb Adjective Noun
ângêre	Noun
Angletëre	Noun
Angoläa	Noun
angôro	Adverb
ânï	Noun
âpe	Noun
ara	Verb
aradoäzi	Noun
aramäni	Noun
ärängö	Adjective
ärëtëngö	Noun
arozêe	Verb
arozoäre	Verb Noun
asa	Verb
äsängö	Noun
âsembë	Noun
asiäkulä	Noun
asîdi	Noun
äsîdi	Noun
äsïkärîsi	Noun
asiparadaräa	Adjective
äsïpërîni	Verb Noun
asura	Noun
âsusu	Noun
âta	Noun
âta-kôlï	Noun
atâa	Adverb Connective Noun
âtarä	Noun
âtawâlï	Noun
âtokua	Noun
atorôni	Noun
avâsi	Noun
âwadüngö	Noun
âwaködörö	Adjective Noun
âwakua	Noun
awe	Adverb Adjective Noun
Azïi	Noun
azudäa	Noun
ba	Verb
bâa	Adjective Verb Noun
Bâa	Verb
bâa-mo-mû	Adverb
Bâamû	Noun
bâan	Noun
babâ	Adjective Noun
baba	Adverb Adjective Noun
bâbâ	Noun
babâ-nzapä	Noun
bäboro	Noun
bâda-halëzo	Noun
bâdahalëzo	Adjective
bâgara	Noun
bäï	Noun
bakarî	Noun
bâke	Noun
bäkongö	Noun
Bäkoyä	Noun
bäkoyä	Noun
balabâla	Noun
balangëti	Noun
balaô	Noun
balasoäre	Noun
bâlâwâ	Noun
bale	Adjective Noun
balë	Adjective Noun
balë-gümbâyä	Adjective Noun
balë-mbârâmbârâ	Adjective Noun
balë-ôko	Verb Adjective Noun
balë-okü	Adjective Noun
balë-omenë	Adjective Noun
balë-osïö	Adjective Noun
balê-ûse	Adjective
balëôko	Adjective
balima	Adjective
bälïmängö	Noun
balöo	Noun
bämarä	Noun
bambî	Adjective Noun
bambinga	Noun
bambü	Noun
bânde	Noun
bändô	Noun
banga	Adjective
bängâ	Noun
bânga	Verb Noun
banga-do	Noun
bängâ-menyan	Noun
banga-tö	Noun
bângbi	Verb
bangë	Noun
bânge	Noun
bângi	Noun
bângîto	Verb
bängö	Adjective Noun
bängö-li	Noun
bängö-likünï	Noun
bängö-mbadi	Noun
bangö-ndo	Noun
bängö-ndo	Verb Noun
banôn	Noun
bânza	Verb
banzö	Noun
bäö	Noun
bara	Noun
barabulëe	Noun
barangba	Noun
bärängö-ndo	Noun
bärängö-terê	Noun
barâse	Noun
barasiëre	Noun
bäräze	Verb Noun
bärâzi	Noun
basënzi	Adjective Noun
bâsi	Adjective Verb Noun
bäsïngö	Noun
bäsïngö-ndo	Adverb
bäsîni	Noun
bata	Adjective Verb Noun
bata-dädä	Noun
bata-dubêre	Verb
bata-kûngbâ	Noun
bata-me	Noun
bata-ndo	Adjective
batabozö	Noun
batada	Adjective Noun
batadädä	Adjective Noun
batadê	Noun
bätängö	Verb Adjective Noun
bätängö-bê	Adjective
bätängö-kôbe	Noun
bataterê	Noun
batayöon	Verb
batêmo	Noun
baterïi	Noun
batonëe	Verb Noun
bavoäre	Noun
bayonëti	Noun
bazën	Noun
bazêngele	Noun
bazîngere	Noun
bê	Noun Verb Preposition Adverb Adjective
be	Verb
bê-nzêe	Noun
bê-nzönî	Noun
Bêafrîka	Noun
bebe	Noun
bêbï	Noun
bêbîâ	Noun
bêgalâ	Verb Noun
bêgerê	Noun
Bekâni	Noun
bekë	Noun
beke	Verb
bêkombïte	Noun
bëkpä	Noun
bêkü	Adverb Noun
bêlawü	Noun
bêlêgë	Noun
bêli	Noun
Bëlïzîki	Noun
belü	Noun
bema	Verb
Bema	Verb
bëmängö	Noun
bembe	Verb
bëmbëngö	Verb Noun
benda	Verb Noun
bêndâmbu	Noun
bendêre	Noun
bêndo	Adjective Noun
Benën	Noun
bengbä	Adjective Verb Noun
bengbä-siröo	Noun
bëngö	Verb Noun
bëngölê	Verb Adjective Noun
bênyämä	Noun
bêôko	Adverb
bere	Verb Noun
berëe	Noun
berîberïi	Noun
bêtâ	Adjective
bëtä	Noun
bêtaâ	Noun
betöon	Noun
bi	Adjective Verb Noun
bï	Adverb Adjective Noun
bî	Noun
bîâ	Adjective Noun
bîâ-lombë	Noun
Bîakü	Adverb
bîakü	Adverb Adjective Noun
bîâkundi	Noun
biandö	Adjective Noun
bîanî	Adverb Adjective Noun
bibê	Adjective Verb Noun
biberöon	Noun
Bîbili	Noun
biböon	Noun
bidöon	Adverb Noun
bïêle	Noun
bîêre	Noun
bigudïi	Noun
bïkua	Noun
bïkua-okü	Noun
bïkua-osïö	Noun
bïkua-otâ	Noun
bïkua-ûse	Noun
bindî	Noun
bindï	Noun
bînga	Verb
bîngbi	Verb Noun
bîngbilö	Noun
bïngï	Noun
bïngo	Adjective Noun
bïngö	Adjective Verb Noun
bïngö-lê	Noun
bïngö-mäbê	Adjective
bïngö-mbeto	Verb
bïngö-nëngö	Noun
bïngö-ngû	Noun
bïngö-tënë	Adjective Noun
bïngö-wûrûwûrû	Noun
bïngö-wûsûwusu	Adjective Noun
biö	Adjective Noun
biöli	Adjective Noun
biöndögô	Verb Noun
biöngbângbâ	Adverb
biöngongo	Noun
bipa	Verb Noun
birä	Adjective Noun
birën	Noun
bîrï	Noun
bîrïbîrï	Adverb Noun
birikëe	Noun
birîki	Noun
bïrïmâde	Noun
bîrîngi	Noun
bïrïngïngö	Adjective Noun
bïrïyätîni	Adjective Noun
biröo	Noun
bisêe	Verb Noun
bîsi	Adverb
biväre	Noun
bîyi	Noun
bö	Verb Noun
boäte	Verb Noun
boatëe	Adverb Verb
bôbô	Noun
boboto	Verb Noun
bogoma	Noun
bôi	Noun
bôi-kotöon	Noun
bôi-kûku	Noun
bôi-lëkërëngö-kutukutu	Noun
bôi-wâlï	Noun
bokôo	Verb Noun
bôle	Noun
boma	Noun
bömä	Noun
bômbe	Noun
bôndekêsi	Adjective
bôndo	Verb
böndö	Verb Noun
bongö	Verb Noun
bongö-kînda	Noun
bongö-mêzä	Noun
bongö-ngû	Noun
bongökua	Noun
bongöngû	Noun
bongönguru	Noun
bordöo	Adjective
boro	Adverb Adjective Noun
bôrö	Noun
börö	Noun
borodële	Noun
boroli	Adverb Adjective Noun
bösö	Adjective Noun
bösôle	Noun
bôsôngbi	Adjective Noun
botiyöon	Noun
Botswana	Noun
bou	Noun
bozo	Adverb
bozö	Noun
bozögo	Verb Noun
bozökëmbëtï	Noun
bozoma	Verb
bozönyama	Noun
buä	Noun
buä-mokönzi	Adjective
bübä	Verb Adverb Adjective Noun
buba	Verb Noun
bübä-yê	Noun
bübängö	Adjective Verb Noun
bübängö-yê	Noun
bûburû	Adjective Noun
bubuta	Verb
bûku	Verb Adjective Noun
bûkugbâsû	Noun
bükulubü	Adjective Noun
bûkülûbü	Adjective Noun
bûkulubû	Noun
bûkumbu	Noun
bülête	Noun
bulöon	Adjective Noun
bûngbi	Adjective Verb Noun
büngbïngö	Verb Noun
büngbïngö-ôko	Noun
büngbïngö-terê	Adjective
Burkina	Verb
Burkinabé	Noun
buruëti	Noun
buruma	Noun
Burundi	Noun
bürüngü	Verb Noun
buruwïi	Noun
busöon	Noun
bûta	Noun
butöon	Noun
butuma	Verb
buzä	Noun
büzë	Verb Noun
buzïi	Verb Noun
da	Verb Adjective Noun
da-etâzi	Noun
da-fungûla	Noun
da-hînön	Adjective Noun
daä	Verb
dabambî	Adjective Noun
dabâsi	Noun
dabê	Adjective Noun
dabî	Noun
dabïngö-pärä	Noun
dabisikïi	Adverb Noun
dabûku	Noun
dabülête	Noun
daburuma	Noun
dabüzë-bûku	Noun
dabüzë-wên	Noun
dadä	Noun
dädä	Noun
dadiyän	Noun
dadödô	Noun
dadüngö	Noun
dafono	Noun
dafonônon	Noun
dagaduru	Noun
dagânda	Noun
dagbätä	Noun
dagbefâ	Noun
dagbï	Noun
dagene	Adjective Noun
dagï	Adjective Noun
dakanda-ngûru	Noun
dakânga	Noun
dakangi	Noun
dakängö-kôbe	Noun
dakängö-kugbëmbëtï	Noun
dakängö-nyama	Noun
dakêe	Verb
dakëngërë	Noun
dakôndo	Adjective
dakôro	Adverb
dakpoto	Noun
dakua	Noun
dakuasû-ngbanga	Noun
dakûku	Verb Noun
dakûngbâ	Noun
dalängö	Noun
dâlê	Noun
dalembë	Noun
dalibebe	Noun
damalînga	Noun
damamêre	Noun
damâpa	Noun
damâti	Noun
damazäni	Noun
dambâ	Noun
dambâgô	Noun
dambeso	Noun
dambëtï-kötä	Noun
dambëtï-längö	Noun
dambipa	Noun
dambïrï	Noun
dambïsü	Noun
damëe	Noun
damêe	Verb
damokandâ	Noun
dändä	Noun
dândâ	Noun
dandaräa	Noun
dandûmbâ	Noun
danga	Noun
dânga	Noun
dangâi	Noun
danganga	Adjective Noun
dangêrë	Noun
dängö	Adjective
dängö-bê	Noun
dangû	Noun
dangûme	Noun
dantikêe	Noun
danyama	Noun
danyïndû	Noun
danyôgbïä	Adjective Noun
danzapä	Noun
danzapä-arâbu	Noun
daôko	Noun
dapärä	Noun
dapïndïrïwâ	Noun
daprëmä	Noun
dapurû	Noun
dara	Verb
daragöon	Noun
därängö	Noun
dasambâ	Noun
dasâsi	Noun
dasêndâgï	Noun
dasimäa	Noun
dasïökörö	Noun
databa	Noun
datatärälê	Noun
datëngö	Noun
datokua	Adjective Noun
datonga	Noun
Daveke	Adjective
daveke	Noun
dawâ	Noun
dawäa	Preposition Adverb Noun
dawësë	Noun
dayïndä	Noun
dayömbö	Noun
dê	Adjective Verb Noun
dë	Adverb Adjective Verb Noun
dëbä	Verb Noun
dedêe	Adjective Noun
dêe	Noun
dêfa	Verb
Defilëe	Noun
dekoletëe	Verb Noun
dëköngö	Verb Noun
dekonzelêe	Verb
deku	Noun
dema	Verb Noun
dëmängö	Adjective Noun
demarëre	Noun
demeredêe	Noun
dendöon	Noun
dênga	Verb
dengbe	Noun
dëngëngö	Noun
dëngëngö-ndo	Verb
dêngi	Verb Noun
dëngïngö	Adjective
dëngö	Adjective Noun
dëngö-bä	Noun
dëngö-bê	Noun
dëngö-kîte	Noun
dëngö-köngö	Noun
dëngö-sêse	Noun
dëngö-terê	Adjective
dëngö-yorö	Noun
deniyëe	Noun
dëpä	Noun
dëpa	Verb
derê	Adjective Noun
derê-to	Noun
derëke	Adjective
Dërëngängö-tënë	Noun
desëre	Noun
devïi	Noun
di	Verb
dï	Verb
diabëte	Preposition Noun
diamäa	Noun
diamäle	Noun
Dibutïi	Noun
didä	Noun
dida	Verb Noun
didi	Adjective Noun
dïdï	Noun
dîko	Verb Noun
dïköngö	Adjective Noun
dïköngö-mbëtï	Noun
diminîi	Verb
dïmïnïngö	Noun
din	Verb
dïnä	Noun
dipïi	Preposition
dïplômo	Noun
dîri	Verb Noun
diridï	Noun
dirima	Adjective Verb
dïrïngö	Adjective Verb Noun
diväan	Noun
diyän	Noun
djîni	Noun
do	Adjective Verb Noun
dö	Adverb Verb Noun
dodo	Adjective Verb
dodô	Adverb Noun
dödô	Noun
dödôgao	Noun
dödörö	Noun
dodoro	Verb
dogbo	Adjective Noun
doläre	Noun
doli	Noun
dôli	Verb
dölïngö	Noun
dôngbi	Verb
dongô	Adjective Noun
döngö	Adjective Verb Noun
dongo	Verb
döngö-ïrï	Verb Noun
döngö-likundû	Noun
döngö-mabôko	Noun
döngö-ndïä	Noun
döngö-nganga	Noun
döngö-tênë	Noun
döngö-terê	Adverb Noun
döngöderê	Noun
döngöli	Verb Noun
dongolo	Noun
döngölöngö	Noun
dôngôngbi	Verb Noun
döngöngbïngö	Noun
doôn	Noun
doro	Verb Noun
doroäa	Adjective Noun
doroko	Adjective Verb Noun
dörököngö	Noun
dörököngö-ndo	Adjective Noun
doromäan	Noun
döze	Noun
dozêe	Verb
dû	Adverb Verb Adjective Noun
dü	Verb
du	Verb Noun
dû-sêtâ	Noun
duanïe	Noun
dûbele	Noun
dubele	Verb
dübeledäa	Noun
dûbelêe	Verb
dubelêe	Verb
dübëlëngö	Adjective Noun
dubere	Noun
dubëre	Noun
dûderê	Noun
dudü	Noun
dûgürü	Noun
dûhôn	Verb Noun
dukâni	Adjective Verb
dükë	Noun
dûkëngë	Noun
dûküä	Noun
dûkûâ	Noun
dûkûkû	Adjective Noun
dûlê	Adjective Noun
dûlüngö	Noun
dûmaka	Noun
düngö	Adjective Noun
düngö-môlengê	Adverb Noun
dûngu	Noun
dûnîa	Adverb Adjective Noun
dünyerë	Adjective Noun
dûse	Noun
dûsembë	Noun
dûsüä	Noun
dûtambö	Noun
dûtênë	Adjective Noun
dutï	Adverb Adjective Verb Noun
dütïngö	Verb Adjective Noun
dütïngö-kpô	Adjective
dütïngö-ngbä	Noun
dütïngö-sêngê	Adjective Noun
duvëen	Noun
dûwâ	Noun
dyâmpa	Verb Noun
dyö	Verb
edêe	Verb
ên	Adverb
en	Adverb Noun
enä	Noun
enterenäa	Noun
esânzi	Noun
esekûte	Noun
fa	Adverb Adjective Verb Noun
fâ	Verb Noun
fâ-nzërë	Noun
fâ-yâ-balë-ôko	Noun
fâa	Verb Noun
fâazëgbësa	Noun
fâbalë-garâmo	Noun
fâbalë-lîtiri	Noun
fadë	Adverb Noun
fâdeku	Noun
fadësô	Adverb
fafadë	Adverb Adjective
fafadësô	Adverb
fâfâra	Adjective Verb
fâfi	Adverb Noun
fâfî	Noun
fakitïri	Noun
fâkötäkörö	Noun
fakpälë	Noun
fâlïndïsa	Noun
fandarä	Noun
fângä	Noun
fängängö	Verb Noun
fângbi	Adverb Verb Noun
fângbi-ngbonga	Adjective
fängbïngö	Noun
fängö	Adverb Adjective Noun
fängö-kôbe	Noun
fängö-lafabëe	Noun
fängö-mbö	Noun
fängö-ndâ	Noun
fängö-täpandë	Adjective
fängö-tënë	Noun
fängö-terê	Verb Noun
fängö-yäkä	Noun
fängö-yê	Noun
fängö-zo	Adjective Noun
fânî	Adjective Noun
fâpozonëe	Verb Noun
fâra	Verb
farânga	Noun
Farânzi	Noun
fâsënë	Noun
fâyätï	Noun
fehö	Noun
femba	Noun
fëtere	Noun
fî	Adjective
fï	Noun
fi	Verb
fin	Verb Noun
fini	Adjective
finî	Adverb Verb Adjective Noun
finî-kôbe	Noun
finön	Noun
fîon	Noun
fîon-kôbe	Noun
firigöo	Noun
fivöngö	Noun
fizëre	Noun
fö	Verb Noun
fölängö	Adjective Noun
folondïgi	Noun
fömbâ	Noun
fombâ	Noun
fôn	Verb
fondo	Noun
fôndo	Noun
föndo	Noun
fono	Adjective Verb Noun
fonôno	Noun
foro	Verb
fôrôrô	Verb Noun
forôto	Adjective Noun
forôtokugbë	Adjective
fü	Adjective Verb Noun
fûe	Noun
fufû	Noun
fuku	Verb Adjective Noun
fukukongö	Noun
fumbä	Noun
fün	Adverb Verb
fûnda-yâ	Noun
füngö	Adjective Noun
füngö-kä	Noun
füngö-pörö	Noun
fungû	Noun
füngü	Noun
fungu	Verb
fungûla	Noun
füngüngö	Noun
fünngö	Adverb Adjective Noun
fünngö-tënë	Noun
fûru	Adjective Verb Noun
furu	Verb
fürüsä	Verb Noun
fûta	Verb Noun
fütängö	Adjective Noun
fütïngö	Adjective Noun
futû	Noun
fûukôndo	Noun
ga	Adjective Verb Noun
gä	Adjective Verb Noun
gâan	Noun
gâba	Adjective Noun
gabä	Noun
gaba	Verb Adjective Noun
gabê	Adverb Adjective
Gaböon	Noun
gada	Noun
gaduru	Adjective Noun
gägängö	Noun
gahïngängö	Noun
gakë	Noun
gakua	Adverb Adjective
galâ-mokönzi	Noun
gale	Adjective
galêsüä	Verb Noun
Gambïi	Noun
gamvara	Adjective Noun
gan	Adverb Verb
gana	Verb
Ganäa	Noun
gänängö	Noun
gânda	Noun
gandïä	Adverb Adjective Noun
gângbi	Verb Noun
gängbïngö	Adjective Noun
gangiliöon	Noun
gängö	Adjective Noun
gänngö	Noun
gänngö-gao	Noun
ganûne	Noun
ganûnu	Noun
ganzâ	Noun
gao	Noun
gapa	Adjective Noun
gapia	Adjective
gâpô	Adjective
garâ	Noun
gara	Verb Noun
garâfu	Noun
garâmo	Noun
garâmo-fâsâki	Adjective
gärängö	Noun
garantïi	Noun
garatïi	Noun
garâzi	Noun
gasua	Verb
gata	Noun
gatënë	Noun
gatöo	Adjective Noun
gavöröngö-Nzapä	Noun
gawa	Verb
gayo	Noun
gazôle	Noun
gazöon	Noun
gbä	Adverb Adjective Noun
gbâ	Adverb Adjective Noun
gba	Noun
gbâ-kusâla	Noun
gbâ-ngbêne-bûku	Noun
gbâ-sembë	Noun
gbâbangë	Noun
gbâbiö	Adjective Noun
gbâbuä	Adjective Noun
gbâda	Noun
gbadara	Noun
gbafu	Noun
gbâgakë	Noun
gbägbä	Adjective Noun
gbägbäda	Noun
gbägbärä	Adjective
gbagbara	Noun
gbagbara-gbongû	Noun
gbägbäsa	Noun
gbägbäwên	Noun
gbâgbru	Adverb
gbâgburu	Adverb Adjective Verb
gbagô	Noun
gbâhûnda	Noun
gbâïrï	Noun
gbâkâ	Adjective
gbâkamâ	Noun
gbâkâmba	Noun
gbâkëkëwâ	Noun
gbâkerebende	Verb
gbâkêrêzê	Noun
gbâkêtê-këkë	Noun
gbakô	Adjective Noun
gbâkôbe	Noun
gbâködörö	Verb Noun
gbâködörö-danzapä	Adjective
gbâkoîlêmbëtï	Verb
gbâkongö	Noun
gbakôpekë	Noun
gbâküä	Adverb Noun
gbâküäli	Noun
gbâkugbë	Noun
gbâkugbëmbëtï	Noun
gbâkûrû	Noun
gbalâka	Noun
gbâlaparä	Noun
gbâlêgô	Noun
gbâlêkëkë	Noun
gbâli	Verb Noun
gbâmbârâtâ	Verb
gbâmosoro	Noun
gbâmotalâka	Noun
gbâmotôro	Noun
gbâmuanyëen	Noun
gbânda	Noun
gbândä	Noun
gbända	Noun
gbândâ	Noun
gbânda-ngungu	Noun
gbandârâ	Noun
gbândeke	Noun
gbândïä	Adjective Noun
gbângängä	Noun
gbangba	Verb Noun
gbânî	Adverb Adjective Noun
gbânyama	Noun
gbânzeomenë	Noun
gbânzeotâ	Verb Noun
gbânzerë	Noun
gbânzi	Adjective Verb Noun
gbänzïngö	Adverb Adjective Noun
gbänzïngö-terê	Noun
gbâpëmbë	Noun
gbara	Verb Noun
gbarabübä	Noun
gbäre	Noun
gbari	Noun
gbasapâsi	Noun
gbâsêki	Noun
gbâsêlê	Noun
gbâsênôn	Noun
gbâsêse	Noun
gbätä	Adjective Noun
gbâtênë	Noun
gbâtolï	Noun
gbâtoto	Noun
gbâturûgu	Noun
gbâûse	Noun
gbâvaka	Verb Noun
gbâwafängö-ngbanga	Noun
gbâyângâ	Adjective
gbâzâ	Noun
gbâzâbängâ	Noun
gbäzägbö	Noun
gbe	Preposition Verb Noun
gbë	Verb
gbebongö	Noun
gbeda	Noun
gbedê	Noun
gbêen	Verb
gbefâ	Noun
gbegô	Adverb Adjective Noun
gbegôbîâ	Noun
gbeködörö	Noun
gbekôti	Noun
gbekpângi	Noun
gbelê	Noun
gbemïngo	Adjective
gbemîngo	Adverb Adjective Noun
gbene	Verb
gbênga	Verb Noun
gbëngängö	Noun
gbëngbë	Adjective Noun
Gbëngbïngö	Verb Noun
gbëngö	Noun
gbenî	Preposition Adverb Adjective Noun
gbenyôgbïä	Noun
gbepörö	Noun
gberë	Noun
gberê	Noun
gbetï	Noun
gbeyâ	Noun
gbï	Verb
gbïä	Adverb Noun
gbïäködörö	Noun
gbîan	Adjective Verb Noun
gbîângbi	Verb
gbïängö	Adjective Noun
gbîânngbi	Noun
gbïänngö	Adjective Noun
gbïanngö	Adjective Noun
gbïänngö-lêgë	Noun
gbîi	Verb
gbikï	Noun
gbïngö	Adjective Noun
gbo	Verb
gbogbo	Noun
gbôgbôlinda	Noun
gbôkamba	Noun
gbôkôrâ	Noun
gböngängö	Noun
gbongô	Noun
gböngö	Noun
gbôo	Verb Noun
gboro	Verb
gbôto	Verb Noun
gbötöngö	Noun
gbötöngö-mê	Noun
gbôzaza	Noun
gbû	Adverb Adjective Verb Noun
gbûbëkpä	Noun
gbugburu	Adverb Verb Noun
gbûkêrêrê	Noun
gbûndeke	Noun
gbüngö	Adjective Noun
Gbüngö	Noun
gbüngö-bê	Adjective
gbüngö-kokö	Noun
gbüngö-li	Noun
gbüngö-terê	Noun
gbüngöli	Noun
gbütängbü	Adjective Noun
gbutu	Noun
ge	Verb
gë	Verb
gëgë	Noun
gegere	Adverb Adjective Noun
gêne	Noun
gene	Verb Noun
gêngi	Verb Noun
gëngö-dû	Noun
genia	Adjective
gepîgepî	Adjective Verb
gepima	Verb
gerê	Adjective Verb Noun
gerê-da	Noun
gerêbokôo	Noun
gerêlâ	Noun
gerêmbëtï	Adverb Noun
gerêosïö	Adjective
gerêsû	Noun
gerêwüngö	Noun
gësi	Adjective
gï	Adverb Preposition Adjective
gi	Adverb Verb Noun
gïä	Noun
gia	Verb Noun
gïängö	Adjective Noun
gïängö-bê	Adverb
gidöon	Noun
gigi	Adverb Adjective Noun
gigï	Noun
gîgî	Noun
gikulûtu	Adjective Noun
gindï	Adjective
gindî	Noun
Ginëe	Noun
gïngö	Noun
gïngö-bê	Noun
gïngö-ndâ	Noun
gïngö-susu	Noun
gïngö-tënë	Noun
gïngö-terê	Noun
gïngö-yângâ	Noun
gïngöyângâ	Adjective
gini	Verb
gino	Adjective Noun
ginon	Adjective Noun
gio	Verb Noun
gïöngö	Noun
gïöngö-bê	Noun
gîra	Adjective Noun
gira	Noun
giriri	Adjective
girisa	Verb Noun
gïrïsängö	Adjective Noun
gïrïsängö-lêgë	Adjective Noun
gïrïsängö-terê	Noun
gô	Verb Adjective Noun
gobïi	Noun
gobo	Noun
godê	Noun
godobe	Noun
godoröo	Noun
göfere	Noun
gogoro	Adjective Noun
gôkoï	Noun
gomatëe	Verb
gömätëngö	Noun
gôme	Noun
gön	Verb
gônda	Adverb Adjective Verb Noun
gonda	Verb Noun
gönngö	Adjective Noun
gönrönngö	Adjective Noun
gôro	Adverb Verb Noun
gorô	Noun
govoroma	Noun
goyävu	Noun
gozo	Noun
gü	Adjective Verb Noun
gua	Verb
gûa	Verb
gûâ	Verb
güägüä	Noun
guaka-ngoi	Noun
güängö	Adjective
gudoröo	Adjective Noun
gue	Adverb Adjective Verb Noun
Gue	Verb
gue-gä	Verb Adjective Noun
güëngö	Adjective Noun
güënngû	Noun
güënnzï	Verb Noun
gugba	Verb
gugë	Noun
guge	Verb
gügü	Noun
gügümä	Noun
guguma	Verb
gügürü	Noun
gûî	Noun
gümbä	Adjective
gümbängö	Noun
gümbâyä	Noun
gündâ	Noun
gündâda	Noun
güngö	Noun
güpakoï	Noun
güpëmbë	Noun
gürü	Adverb Adjective Noun
güsüyömbö	Noun
hä	Verb Noun
hâka	Verb Noun
hâka-bebëe	Noun
hâka-nëngö	Noun
hâkalö	Noun
häkängö	Adjective Noun
häkängö-zo	Noun
hâko	Adverb Adjective
hâko-gbefâ	Noun
hâkolö	Noun
halë	Adjective Noun
halë-zo	Noun
halëzo	Adjective
hän	Verb
hana	Verb
hänä	Verb Noun
hânda	Adverb Adjective Verb Noun
hânda-lê	Noun
handâa	Connective
hândalê	Adjective
händängö	Noun
händängö-ndo	Noun
hânge	Adverb Adjective
hängö-lê	Noun
hänngö-lê	Verb Noun
harara	Noun
hâriâ	Adjective Noun
he	Verb Noun
hë	Verb Noun
helô	Adjective
hêlo	Adjective Noun
helö	Noun
henä	Verb Noun
hënë	Adjective Verb Noun
hene	Verb Noun
hëngö	Adjective
hëngö-ndo	Adjective Noun
hëngö-ngîâ	Adjective
hëngö-zo	Verb Noun
here	Verb Noun
hînga	Adjective Verb Noun
hîngângbi	Noun
hïngängö	Adjective Noun
hïngängö-mbëtï	Noun
hïngängö-ndo	Noun
hïngängö-sïökpärï	Verb
hïngängö-sïönî	Noun
hîngö	Adjective Noun
hini	Verb
hîni	Verb Noun
hinika	Verb
hïnïkängö	Noun
hînön	Adjective Noun
hîo	Adverb Adjective
ho	Verb
holê	Noun
hôle	Verb
hölëngö	Noun
hön	Adjective Verb
hon	Verb
hôn	Verb Adjective Noun
hônbâgara	Noun
hônde	Adjective Verb Noun
hônde-kpû	Verb Noun
hônde-lê	Adjective Noun
höndëngö	Noun
höndëngö-terê	Noun
hônga	Adverb Adjective Verb Noun
Hônga	Noun
höngö	Verb Noun
hönlê	Verb
hönngö	Adjective Noun
hönngönî	Adjective
hôntï	Noun
hötö	Noun
hü	Verb Noun
hûle	Verb
hülëngö	Adjective
hûnda	Verb Noun
hündängö	Noun
hündängö-halëzo	Noun
hunu	Verb Noun
hûnzi	Verb
hünzïngö	Noun
hûru	Verb
huru	Verb Noun
huruka	Verb Noun
hürükängö	Noun
hürüngö	Noun
hüzünî	Adverb Noun
ikitêre	Noun
ikitëre	Verb Noun
imâme	Verb Noun
îngö	Noun
irä	Noun
ïrï	Adverb Adjective Verb Noun
îri	Verb Noun
ïrïngö	Noun
ïrïngö-ndo	Noun
ïrïngö-zo	Noun
isilâmo	Noun
îtä	Adjective Noun
îtä-wâlï	Noun
îtäkôlï	Noun
izîni	Verb Noun
izîni-sâa	Noun
izîniwên	Noun
ka	Adverb
kâ	Adverb
kä	Adverb Verb Noun
kâ-yê-kûê	Noun
kâa	Noun
kabinëe	Noun
kadâ	Noun
kâfä	Noun
kâi	Verb Noun
kâî	Verb Noun
kâi-lörö	Noun
kâidiabête	Adjective Noun
käïngö	Adjective Noun
kakâ	Noun
kakaöo	Noun
kakaûka	Noun
kakö	Noun
kakösënë	Noun
kaküë	Noun
kaläa	Noun
kaladi	Noun
kalamêe	Verb
kâlângbâ	Noun
kalaöo	Noun
kâle	Noun
kalê	Noun
kalêe	Verb Noun
kalesöon	Noun
kalitëe	Noun
kamâ	Noun
kâmâ	Noun
kamâ-ôko	Noun
kamâkôte	Adjective Noun
kamâsïö	Noun
kamâta	Verb
kamba	Noun
kâmba	Verb Adjective Noun
kâmbasöngö	Noun
kambîri	Adjective
kambisa	Verb Noun
kambûsu	Verb Noun
kamëme	Connective Verb
kamënë	Adjective Verb Noun
kameräa	Noun
Kamerûne	Noun
kamisä	Noun
kamisa	Verb
Kanadäa	Adjective Noun
kanapëe	Noun
kandâ	Noun
kandângû	Noun
kândo	Noun
kandöo	Adjective Noun
kângâ	Noun
kängä	Noun
kânga	Preposition Adjective Verb Noun
kânga-gbogbo	Noun
kânga-ndaû	Noun
kânga-pupu	Noun
kängäli	Noun
kängängö	Verb Adjective Noun
kängängö-lê	Adjective
kängängö-lêgë	Noun
kangba	Adjective Noun
kängbä	Noun
kângbi	Adjective Verb Noun
Kângbi	Verb
kängbïngö	Noun
kängbïngö-marä	Noun
kangi	Noun
kângî	Noun
kängö	Adjective Verb Noun
kängö-zo	Noun
kangû	Noun
känîfu	Noun
kansëre	Noun
kanya	Noun
kânyâ	Noun
kanzagô	Noun
kaoya	Noun
kâpä	Noun
kâpämbai	Noun
kâpe	Noun
Kâpevêre	Noun
kapï	Noun
kapïta	Adjective Noun
kapitûla	Adjective Noun
kapöo	Noun
kaporäle	Noun
kara	Adjective Verb
kâra	Noun
käräbîni	Noun
karabiratëre	Noun
käräbôni	Noun
karagbikï	Noun
kârâgorô	Noun
karakânzi	Noun
kârâkö	Noun
käränävâle	Noun
karanëe	Noun
kärängö	Adjective Noun
karapîri	Adjective Noun
karapîrî	Noun
kârârâ	Adverb
kârâte	Noun
karatëe	Noun
karatö	Noun
karatöon	Noun
karavâti	Noun
Karazêe	Verb
kärêmo	Noun
kariëre	Noun
karïi	Verb Adjective Noun
kärôte	Noun
kâsa	Adjective Noun
kasa	Verb Noun
kasâka	Noun
käsêti	Noun
kâsi	Noun
kâsiki	Adjective Noun
kätä	Noun
katapiläa	Noun
kate	Adjective Noun
katebongö	Noun
kâtekâte	Noun
katikâti	Adjective Noun
katiri	Adjective Noun
kätîsi	Noun
kätölîki	Adjective
kausüu	Noun
kâwa	Noun
kawoya	Noun
kâya	Noun
kayëe	Noun
kazâka	Noun
kaziëe	Noun
ke	Adjective Verb Noun
kë-ngû	Noun
këgbogbo	Noun
këkë	Verb Noun
këkë-gôro	Noun
këkë-kâwa	Noun
këkë-päsä	Noun
këkë-pendo	Adjective
kêkêre	Noun
kekere	Verb Noun
kekerêke	Adjective Noun
këkësâi	Noun
kêkêtê	Adjective Noun
këkëwâ	Noun
kêlê	Adverb Verb
kelemba	Noun
këlëngö	Noun
këmbëtï	Adjective Noun
kembï	Noun
kendümbü	Adjective
kënë	Adverb Noun
kêngbi	Verb
këngbïngö	Adjective Noun
këngë	Adjective Noun
këngërë	Adjective Noun
kêngêrê	Adverb Adjective
kengere	Verb
këngö	Verb Adjective Noun
këngö-kua	Noun
këngö-tënë	Noun
këngö-yê	Noun
këngö-zo	Adjective Noun
Keniyäa	Noun
kepaka	Noun
kepëe	Noun
kepïi	Noun
këpôme	Noun
kere	Adjective Noun
kêre	Noun
kërë	Noun
kerebende	Adjective Noun
kerelê	Noun
keremba	Adjective Noun
kêrênzê	Noun
kêrêrê	Noun
keretïen	Noun
kêsi	Noun
kêtê	Adverb Verb Adjective Noun
Kêtê	Noun
kete	Verb
kêtê-bozö	Noun
kêtê-da	Noun
kêtê-këkë	Noun
kêtê-kôsö	Noun
kêtê-marä	Noun
kêtê-ngûnzapä	Noun
kêtê-tasêse	Noun
këtëngö	Noun
kêtêngû	Noun
ketüä	Noun
kêü	Noun
ki	Adverb Verb Noun
kî	Verb Noun
kiakia	Adjective Noun
kibângu	Noun
kîbê	Noun
kifo	Verb Noun
kïföngö	Verb Noun
kîki	Verb
kïkïngö	Noun
kiliän	Noun
kilomêtere	Noun
kilöo	Adjective Noun
kilöo-ngbangbo	Noun
kïlôti	Noun
kînda	Noun
kinda	Verb Noun
kindânda	Noun
kïngö	Noun
kinîni	Noun
kîo	Adjective Verb
kïön	Adjective Noun
kïöngö	Noun
kipêe	Adjective Noun
kiri	Noun
kîri	Verb Noun
kîri-hûnda	Verb Noun
kîri-yângâ	Noun
kîrîki	Noun
kîrîkiri	Adverb Adjective Verb Noun
kîrindönî	Noun
kîringêrë	Noun
kïrïngö	Verb Noun
kîrö	Noun
kîro	Verb
kiro	Verb
kïröngö	Verb
kirôro	Noun
kîsiri	Noun
kisoro	Noun
Kitâbu	Adjective
kitâbu	Noun
kitambûla	Noun
kitâra	Noun
kîte	Adjective Noun
kîti	Adverb Verb Noun
kiti	Verb
kö	Verb Noun
kobadangbondâ	Adjective
kobagûên	Noun
kobambeto	Noun
kobasënzënngö	Noun
kobawâ	Noun
kôbe	Verb Adjective Noun
kobêla	Adjective Noun
köböndo	Noun
kodë	Adjective Verb Noun
kodë-birä	Noun
kodë-ndö	Noun
kodëkua	Noun
kodësû	Adjective Noun
Kôdivöari	Noun
ködörö	Verb Adjective Noun
ködörö-kömändâ	Verb
ködörö-va	Noun
ködörö-wandê	Verb
ködörösêse	Noun
kôgarä	Adverb Noun
koîlêmbëtï	Noun
kokäa	Noun
kokö	Noun
kokômbo	Noun
koköo	Noun
kokora	Noun
kökötä	Adverb Adjective
koläa	Adjective
Kolêe	Verb
kolêe	Verb
kolêekolêe	Adjective
kölëngö	Adjective
koleräa	Adjective Noun
kölêzi	Noun
Kôlï	Adjective
kôlï	Adjective Noun
koli	Noun
kôlï-kôndo	Noun
kôlï-ngäsa	Noun
kôlï-wakua	Noun
kôlï-wâlï	Noun
kolîngo	Noun
kôlïtaba	Noun
kôlô	Noun
kôlokôtö	Adjective Noun
kôlökôtö	Noun
kolongo	Noun
komä	Noun
kömändâ	Noun
komandêe	Verb
kömändëmä	Noun
komandöo	Noun
kombâ	Noun
komberëe	Adjective Noun
kombûka	Verb Noun
kombûta	Adjective Noun
kömë	Verb Noun
komïi	Noun
kömïnîsi	Verb Noun
kömïön	Noun
komisarïa	Noun
komisëre	Noun
Komôro	Noun
komvî	Adjective Noun
kônde	Adjective Noun
köndëngö	Adjective
kôndo	Noun
köndö	Noun
kondoäre	Noun
köndôme	Noun
kongä	Noun
kongba	Noun
köngbânge	Noun
kôngbâterê	Adjective
köngö	Adjective Noun
kongö	Adjective Noun
Kongö	Noun
kono	Adverb Verb Noun
konö	Noun
konogô	Noun
konolê	Noun
könömï	Noun
könöngö	Adjective Noun
könöngö-gerê	Noun
könöngö-lê	Noun
konza	Noun
kopäa	Noun
köpërätîve	Noun
köpërêse	Noun
kopo	Noun
kopohîngö	Noun
Kopokêlêlê	Noun
köpôte	Verb Noun
kopu	Noun
korbô	Verb
körö	Noun
kôro	Verb Noun
koro	Verb Noun
koroäa	Verb Noun
korobiyäre	Noun
korobô	Noun
kôrodû	Adjective Noun
körökate	Noun
köröngö	Noun
korôrö	Noun
koso	Noun
Koso	Verb
kösöngö	Noun
Kötä	Verb
kötä	Verb Adverb Adjective Noun
kötä-bê	Adjective Noun
kötä-bongö	Noun
kötä-dïnä	Noun
kötä-hötö	Noun
kötä-kêsi	Noun
kötä-kilôte	Noun
kötä-körö	Noun
kötä-ngö	Noun
kötä-tasêse	Noun
kötä-yâ	Noun
kötä-zo	Noun
kötäbuä	Noun
kötäkötä	Adverb Adjective
kötälâ	Adjective
kötämbeto	Noun
kötarä	Noun
kötätênë	Noun
kötäyâ	Verb Noun
kotëre	Noun
kötï	Adjective Noun
koti	Noun
kôto	Noun
koto	Verb Noun
kotôko	Noun
kötöngö	Noun
kôya	Adjective Noun
kôzo	Adverb Adjective Noun
kôzo-tanga	Noun
kôzonî	Adverb Adjective Noun
kpâ	Noun
kpa	Verb
kpa-mbo	Noun
kpâa	Adverb
kpâda	Noun
kpafira	Noun
kpaga	Noun
kpaka	Verb Noun
kpäkängö	Verb Noun
kpäkängö-mbamba	Noun
kpakâra	Noun
kpakata	Noun
kpäkë	Adjective
kpäkpä	Noun
kpäkpä-yângâda	Noun
kpakpalêngû	Noun
kpakpö	Noun
kpäkpö	Noun
kpâkü	Noun
kpâku	Noun
kpala	Verb
kpälë	Adverb Adjective Verb Noun
kpändä	Noun
kpängäbä	Noun
kpângbä	Noun
kpangbala	Noun
kpângbârâ	Adjective Noun
kpângi	Noun
kpängö	Noun
kpängö-terê	Noun
kpârâköngö	Noun
kpâtîâ	Adjective
Kpätîâ	Adjective Verb
kpayama	Adverb Verb Noun
kpäyämä	Noun
kpë	Adjective Verb Noun
kpê	Noun
Kpë	Verb
kpëbiö	Noun
kpekpë	Noun
kpekpêe	Adjective
kpëli	Noun
kpêndâ	Adjective
kpendä	Noun
kpenda	Verb Noun
kpêne	Adjective Noun
kpëngbä	Adjective Noun
kpêngba	Adjective Verb Noun
kpëngbä-li	Verb
kpëngbängö	Adjective Noun
kpëngbängö-li	Adjective Noun
kpëngö	Adverb Adjective Verb Noun
kpëngö-da	Noun
kpëngö-dambëtï	Noun
kpëngö-zo	Noun
kpengü	Adjective Noun
kpenzü	Noun
kpëpëmbë	Noun
Kpere	Verb
kpere	Verb Noun
kperekpere	Noun
kperema	Verb
Kperema	Verb
kpia	Verb Noun
kpïängö	Noun
kpikpîi	Adjective
kpïngbängö	Adjective Noun
kpîtî	Adjective
kpîtîkpîtî	Adjective
kpitima	Verb
kpö	Adjective
kpo	Adjective Verb Noun
kpô	Adverb Adjective Verb Noun
kpökä	Adverb Noun
kpoka	Noun
kpôkpo	Noun
kpôkpô	Noun
kpön	Adjective Noun
kpöndö	Adjective Noun
kpongbo	Noun
kpöngö	Adjective Noun
kpöngö-terê	Noun
kporo	Verb
kporôkpo	Noun
kpöröngö	Adverb Adjective Noun
kpoto	Verb Noun
kpu	Adverb Noun
kpû	Noun
kpûkpû	Verb Noun
kpûkuräan	Noun
kpûlê	Noun
kpuruka	Verb
kpûrûrû	Noun
kpûsöngö	Adjective Noun
kpuu	Interjection
kpuwâ	Noun
ku	Verb
kü	Verb
küä	Adjective Noun
kûâ	Adverb Adjective Noun
kuä	Noun
kua	Verb Adjective Noun
kua-kpâda	Noun
küä-li	Adjective
küälê	Noun
küäli	Adjective Noun
kuamanda	Noun
kuasango	Noun
küäterê	Noun
küäterêtaba	Noun
kuatï	Noun
küäyângâ	Noun
kuba	Verb Noun
kübängö	Noun
kubû	Noun
küdä	Noun
kûdetäa	Noun
kûê	Adverb Adjective Noun
kûêkûê	Adverb Adjective
küësêse	Noun
kugbë	Noun
kugbëkâsa	Noun
Kûi	Verb
kûi	Verb Noun
kûkû	Noun
kûku	Verb Noun
kukûna	Adjective
kukûne	Adjective
küküngö	Noun
kûkurû	Noun
külä	Adjective Noun
kulä	Noun
kulûtu	Adjective Noun
kûma	Noun
kundi	Adverb Adjective Noun
kundü	Adjective Noun
kündü	Noun
kundu	Verb Noun
kûne	Adjective
künë	Noun
kûngbâ	Verb Noun
kûngbi	Verb
küngbïngö	Noun
küngö	Noun
kûngûlûbä	Noun
kunî	Adjective Noun
künï	Noun
kunibê	Noun
kûpe	Noun
kürä	Noun
kuräa	Noun
kuräan	Adjective
Kurazemäa	Noun
kürü	Adverb Adjective Noun
kürü-ndo	Adjective Noun
kurua	Noun
kûrûbe	Noun
kürüngü	Noun
kusinëe	Noun
kûtu	Noun
kûtugô	Noun
kutukutu	Noun
lâ	Adjective Verb Noun
labatoära	Noun
ladaräa	Noun
laduâni	Noun
lafabëe	Noun
lafâi	Noun
lafâye	Noun
lägërëmä	Noun
lagorôti	Noun
lâi	Noun
lakata	Verb
läkätängö	Adjective Noun
lakërë	Noun
lakerëe	Noun
lâkûê	Adverb Adjective Verb Noun
lâkûi	Noun
lamânde	Noun
lamantêen	Noun
lamatîsi	Noun
lâmba	Noun
lâmbalêgë	Noun
lamböo	Noun
lamêrede	Noun
lamêrêde	Noun
lamôde	Noun
lamôroke	Noun
lamorokêe	Verb Noun
lando	Adjective Noun
ländrîni	Noun
längbä	Noun
längö	Adjective Verb Noun
längöngö	Adjective Noun
laparä	Noun
lâpôso	Noun
lärämä	Noun
laramoära	Verb Adjective Noun
Larënïon	Verb Noun
lâsi	Noun
lâsô	Adverb Adjective
lasöro	Noun
lâte	Noun
latêen	Adjective
lâto	Verb Noun
latrête	Noun
lâwa	Adverb
lâyenga	Noun
lazüära	Noun
lë	Adjective Verb Noun
lê	Adverb Adjective Noun
lê-na-lê	Noun
lêda	Noun
lêgbânda	Noun
lêgë	Adverb Adjective Verb Noun
lêgë-këkë	Noun
lêgë-ôko	Adjective
lêgëgbedû	Adjective Noun
legelege	Adjective
legema	Noun
lêgëôko	Adverb Adjective Noun
lêgëwên	Noun
leke	Adverb Adjective Verb Noun
lêkëkë	Verb Adjective Noun
lêkêngbi	Noun
lëkëngö	Verb Adjective Noun
lëkëngö-bê	Noun
lëkëngö-terê	Noun
lekere	Adverb Verb Noun
lëkërëngö	Noun
lëkërëngö-bongö	Noun
lêkôbe	Noun
lele	Noun
lêmbe	Adjective Noun
lêmbëtï	Noun
lêmekä	Noun
lëndâ	Noun
lendë	Adjective
lëndë	Adjective
lêndo	Adverb Adjective Noun
lêndüzü	Noun
lengbe	Adjective Noun
lêngbö	Noun
lenge	Adjective Noun
lêngê	Noun
lëngö	Adverb Adjective Verb Noun
lëngö-dädä	Noun
lëngö-gbïä	Adjective Noun
lëngö-ködörö	Noun
lëngö-mandako	Noun
lëngö-ngangü	Verb Noun
lêngoa	Noun
lêngombe	Noun
lêngû	Adjective
lêngühîngö	Noun
lêpêrë	Noun
lesevëre	Noun
Lesoto	Noun
lësüä	Adjective Noun
lesua	Adjective Verb
lesuä	Noun
lêwâ	Adjective
lêwên	Noun
lêyângâda	Noun
lêyongö	Noun
li	Adverb Adjective Verb Noun
lï	Verb
Lia	Verb
lîâ	Verb
Libêria	Noun
libîâ	Noun
Libîi	Noun
lida	Verb Noun
ligbegô	Noun
likî-zigo	Noun
lîkilî	Adjective Noun
lîkirî	Noun
likisi	Adjective
likisï	Adverb Adjective Noun
likôlo	Adjective
likongô	Noun
likongö	Noun
likundû	Noun
likûne	Adjective Noun
likünï	Noun
likünü	Noun
limbômbô	Adjective Noun
lime	Noun
limo	Adjective Verb Noun
lîmo	Noun
lîmo-nzapä	Noun
limolê	Noun
limondo	Noun
limosûkô	Noun
lindä	Noun
linda	Verb
lïndängö	Noun
lindisû	Noun
lïngä	Noun
lîngbi	Verb Noun
lïngbïngö	Adjective Noun
lingendê	Noun
lîngîsî	Adjective Noun
lïngö	Adverb Adjective Noun
lïngö-kobêla	Verb
lïngöngû	Noun
lingû	Adverb Noun
lïngû	Verb
lingûngbi	Noun
lipandäa	Noun
lipë	Noun
lipëtê	Noun
lisâsi	Noun
lisëe	Noun
lisorö	Adverb Noun
litênë	Adjective Noun
litënë	Noun
litï	Noun
lîtiri	Noun
lîtiri-fâsâki	Noun
lito	Noun
litûtu	Adjective
lo	Pronoun
lö	Verb
lo-ôko	Adverb Noun
lobo	Adjective
löbömä	Noun
loboma	Verb
lögöbëngö	Adverb
lôlo	Noun
lölömä	Noun
lombë	Adverb Adjective Noun
lombe	Noun
lömbëtï	Adjective Noun
londële	Noun
Löndö	Verb
löndö	Verb Noun
löndöngö	Noun
löndöngö-bê	Adjective Noun
löndöngö-terê	Noun
lôngbi	Verb
löngö	Adverb Adjective Verb Noun
löngö-yâ	Noun
lônzi	Verb
lônzilö	Noun
lönzïngö	Verb Noun
lörö	Adverb Adjective Noun
lôso	Noun
lötï	Verb Noun
lötïngö	Adjective Noun
lü	Adjective Verb Noun
lûbâ	Adjective
luba	Verb Noun
luëe	Verb
luêe	Verb
luemäa	Noun
lüëngö	Noun
lûku	Verb Noun
lüküngö	Adjective Noun
luma	Noun
lüngö	Verb Noun
lüngö-këkë	Noun
lüngö-kûâ	Noun
lüngö-ndïä	Noun
lûngu	Verb Noun
lungülängö-tënë	Noun
lütï	Verb
lütïngö	Noun
lututu	Adjective
mâ	Noun
mä	Verb Noun
Mäbê	Adjective
mäbê	Noun
mabôko	Verb Adjective Noun
mäda	Noun
mafüta	Adjective Noun
magazäni	Noun
Magerêbe	Noun
mâi	Verb Noun
mäïngö	Adjective Noun
makâko	Noun
makandâ	Noun
makara	Noun
makaronïi	Noun
makayâbo	Noun
makongö	Verb Noun
makorôbe	Noun
makoröo	Verb Noun
makûu	Noun
mâlâfa	Noun
Malïi	Noun
mälö	Noun
mamâ	Adjective Noun Interjection
mamâ-danzapä	Noun
mamâbibê	Noun
mamâme	Noun
mamïön	Noun
mamîwatâ	Noun
mänä	Noun
mana	Verb
mändä	Noun
manda	Verb Noun
mandako	Noun
mändändö-kua	Noun
mändängö	Verb
mändängö-yê	Adjective Noun
mandarîni	Noun
mandërë	Noun
mânga	Noun
mangbêlê	Verb Noun
Mângbi	Adjective
mângbi	Adjective Verb Noun
mangbôkô	Verb Noun
mangêe	Verb Noun
mängëngö	Noun
mängö	Noun
mângo	Noun
mängö-fîon	Adjective Noun
mängö-ndo	Noun
mängö-ngbanga	Noun
mängö-nzërëngö	Noun
mängö-terê	Verb
mängö-yâ	Adjective Noun
mängö-yângâ	Adjective Verb Noun
mangöo	Noun
mänïvêle	Noun
mâpa	Noun
mapîâ	Noun
mäpö	Noun
mapo	Noun
mapô	Noun
marä	Adjective Noun
marä-belü	Noun
marä-fondo	Adjective
marabüu	Noun
maratöo	Noun
maseka	Adjective Verb Noun
masêre	Noun
masïni	Verb Noun
masïni-betöon	Verb
masïni-bîâ	Noun
masïni-kônde	Noun
masïni-ngûwâ	Adverb
mäsïtîke	Noun
mäsû	Noun
masûa	Noun
matabïsi	Adjective Noun
matabïsi-birä	Noun
matânga	Adverb Adjective Verb Noun
matarâke	Noun
mateläa	Noun
matênge	Noun
mato	Noun
mawa	Adverb Adjective Verb Noun
mayëre	Noun
mayöo	Noun
mâzawîli	Noun
mazorête	Noun
mba	Verb
mbâ	Verb Noun
mbâgë	Adverb Preposition Adjective Noun
mbai	Adjective Noun
mbäkôro	Adjective Noun
mbäli	Noun
mbamba	Noun
mbâmbe	Noun
mbänä	Adverb Adjective
mbangana	Noun
mbânge	Noun
mbângö	Adjective Noun
mbängö	Noun
mbârâmbârâ	Adjective
mbârâtâ	Noun
mbasêlî	Noun
Mbätä	Noun
mbätä	Noun
mbätä-ûse	Noun
mbelêka	Noun
mbênî	Adverb Adjective Noun
mbere	Verb Noun
mbësä	Noun
mbeso	Verb Noun
mbeso(tî	Adjective Noun
mbëtï-sambêla	Verb
mbëtï-tambûla	Noun
mbëtï-timöon	Noun
mbëtï-yorö	Noun
mbëtïkâpä	Noun
mbëtïngêrë	Noun
mbëtïsêlê	Noun
mbëtïvôte	Noun
mbeto	Adverb Adjective Noun
mbï	Pronoun
mbîndä	Noun
mbïö	Noun
mbïökuälê	Verb Noun
mbipa	Noun
mbîrîmbîrî	Adjective Noun
mbo	Noun
mbö	Verb Noun
mbôko	Verb Noun
mboma	Adjective Noun
mbombi	Noun
mbômbô	Adjective
mbomböo	Noun
mbongo-do	Noun
mbongo-tö	Noun
mbôo	Verb Noun
mboro	Adjective Verb Noun
mboyö	Noun
mbre	Noun
mbren	Noun
mbu	Noun
mbua	Noun
mbûki	Adjective Noun
mbumbuse	Adjective Verb Noun
mbünë	Noun
mbupa	Noun
mbupu	Noun
mbûrü	Noun
mburuwâ	Adjective
mbürüwâ	Noun
mbütü	Adjective Noun
mê	Noun
me	Verb Noun
më	Verb Noun
meka	Adjective Verb Noun
mekä	Noun
meka-ndowâ	Noun
meka-ngû	Verb Noun
mëkängö	Noun
mêkê	Adjective
mênë	Adjective Noun
mene	Verb Noun
mëngä	Noun
mëngö	Verb Adjective Noun
mënôte	Noun
menya	Verb
meredêe	Verb
mêsi	Noun
mêtere-fâsâki	Noun
mêya	Noun
mêzä	Verb Noun
mï	Adjective Verb
mî	Adjective Verb Noun
mi	Noun
miambe	Adjective Noun
mîfi	Adjective Noun
mimîi	Adjective
mimîibê	Noun
mina	Verb Noun
mîne	Noun
mîngi	Adverb Adjective Noun Interjection
mïngö	Adjective Noun
mîngo	Verb Noun
mîngo-fâ	Noun
mïngöngö	Noun
minimîni	Noun
mîon	Noun
mïönngö	Noun
mîro	Verb
mïröngö	Noun
mîsa	Noun
mîsahînön	Noun
mitä	Adjective
mîtën	Noun
mo	Pronoun
mobango	Adjective Noun
mobimba	Adjective Noun
mobutu	Noun
modô	Noun
mokandâ	Noun
mokandä	Noun
mokasëen	Noun
mokërëlö	Noun
mokondö	Verb Noun
mokönzi	Noun
mokönzi-wâlï	Noun
môlengê	Noun
môlengê-Nzapä	Noun
molongö	Adjective Noun
molongö-tüngë	Verb
mondêe	Verb
môndoro	Noun
monya	Noun
monzën	Noun
mopêre	Noun
Moritäni	Noun
morôko	Adjective
Morôko	Noun
moskëe	Noun
mosoro	Adverb Adjective Noun
motalâka	Noun
motëre	Noun
motîndo	Noun
moyayä	Adverb Noun
Mozambîka	Noun
mozën	Noun
mozoko	Adjective Noun
mû	Adverb Adjective Verb Noun
mü	Verb
mû-längö	Noun
müä	Adjective Noun
müälê	Noun
muen	Noun
mûgô	Noun
mûlu	Verb Noun
mümänä	Noun
mumana	Verb Noun
münä	Verb Noun
Münë	Noun
mungä	Noun
müngö	Adverb Adjective Noun
müngö-dädä	Noun
müngö-kä	Noun
müngö-kobêla	Noun
müngö-mabôko	Verb Noun
müngö-me	Verb Noun
müngö-ndo	Noun
müngö-ngîâ	Noun
müngö-pekô	Noun
müngö-pupu	Verb
müngö-tënë	Noun
müngö-wâlï	Noun
müngö-wâlï-ûse	Noun
müngö-yângâ	Noun
müngö-yê	Noun
munzû	Noun
muyêe	Verb
müyëngö	Adjective Noun
mve	Noun
mvele	Noun
mvene	Verb Adverb Adjective Noun
mvenî	Adjective
mvönkëkë	Noun
mvuka	Noun
mvulê	Noun
mvumvü	Noun
na	Noun Verb Preposition Adverb Adjective
naköo	Noun
Namibïi	Noun
nâpe	Noun
ndâ	Adjective Verb Noun
ndâadê	Noun
ndâgerê	Noun
ndâgô	Noun
ndâkëngë	Noun
ndâkpälë	Noun
ndâlêgë	Verb Noun
ndâli	Preposition Adjective Noun
ndâmânga	Noun
ndâmbo	Adjective Noun
ndâmbo-lîtiri	Noun
ndâmbo-ndângîâ	Adverb
ndâmbo-ngbonga	Noun
ndâmbo-ngêrë	Noun
ndândo	Noun
ndândüzü	Noun
ndânga	Verb Noun
ndângbâ	Adjective
ndângbâ-tënë	Noun
ndângörö	Noun
ndângôrö	Noun
ndânî	Adverb
ndânzërë	Noun
ndao	Adjective Noun
ndäpêlêlê	Adjective Noun
ndârâ	Adjective
ndarä	Adverb Verb Adjective Noun
ndaramba	Noun
ndâsêse	Noun
ndâtënë	Noun
ndâtûku	Noun
ndaû	Noun
ndâwâ	Noun
ndâyâlê	Noun
ndâyenga	Noun
ndê	Adverb Adjective Noun
ndeke	Noun
ndeko	Noun
ndembë	Noun
ndembö	Noun
ndêndê	Adverb Adjective
nderere	Adjective
ndïä	Adjective Noun
ndiâ	Verb
ndïä-matânga	Adjective Noun
ndïäyângâ	Noun
ndikâ	Noun
ndikiri	Verb
ndimä	Adverb Verb Adjective Noun
ndîmo	Noun
ndindïä	Noun
ndo	Adjective Verb Noun
ndö	Preposition Adjective Noun
ndö-bê	Adjective Noun
ndo-ginon	Noun
ndo-höndëngö	Noun
ndo-höndëngö-terê	Noun
ndo-hönngö	Noun
ndö-mbütü	Noun
ndo-sükülängö-bongö	Adjective
ndobätängö-kûngbâ	Noun
ndobätängö-ndeke	Noun
ndögüda	Noun
ndoî	Noun
ndokoï	Noun
ndokua-pörö	Verb
ndolängö	Noun
ndolisorö	Noun
ndolötïngö	Noun
ndolütïngö	Noun
ndömbâ	Adjective Noun
ndomba	Verb Noun
ndömbâ-yorö	Verb
ndombe	Noun
ndömbütü	Noun
Ndondöli	Noun
ndongere	Verb
ndôngô	Noun
ndönî	Adverb
ndoro	Noun
ndörö	Verb Noun
ndosürüngö-mabäyä	Verb
ndowa	Adverb
ndowâ	Adverb Noun
ndoyê	Adjective Verb Noun
ndü	Verb
ndû	Verb
Ndümbä	Noun
ndümbü	Adjective Verb
ndüngö-terê	Verb
ndurü	Noun Verb Preposition Adverb Adjective
ndûru	Verb Noun
ndurü-biö	Noun
ndûrûkpâ	Adjective Noun
ndurüsû	Noun
ndütü	Noun
ndutu	Noun
ndüzü	Adverb Adjective Verb Noun
ne	Verb Noun
neka	Verb Noun
nenêe	Adverb Adjective Noun
nenêe-tënë	Noun
nenëe-tö	Noun
nëngö	Adverb Adjective Noun Interjection
nëngö-terê	Adjective Noun
nëngö-wâlï	Adverb Noun
ngâ	Adverb
ngâakô	Noun
ngaba	Noun
ngadï-ngû	Noun
ngaduru	Noun
ngambe	Adjective Noun
ngän	Noun
nganda	Noun
Nganda	Noun
nganga	Adjective Noun
ngängä	Noun
ngängägerê	Noun
ngangü	Adverb Verb Adjective Noun
ngangü-kûê	Adverb
ngangü-li	Verb Noun
ngangü-yê	Noun
ngangüli	Noun
nganzi	Noun
ngâo	Noun
ngara	Noun
ngäsa	Noun
ngâsi	Verb
ngata	Noun
Ngazï	Noun
ngbâ	Adverb Verb
ngbä	Noun
Ngbâ	Verb
ngbâa	Adverb Adjective Noun
ngbaba	Noun
ngbädä	Noun
ngbâko	Verb Noun
ngbâkongö	Noun
ngbakpä	Noun
ngbängä	Noun
ngbanga	Preposition Noun
ngbangbo	Noun
ngbangbo-lîtiri	Noun
ngbangbo-mêtere	Noun
ngbängö	Noun
ngbängö-na-li	Verb
ngbênabê	Noun
ngbëndä	Noun
ngbëndä-gerê	Adverb
ngbêne	Verb Connective Adjective Noun
ngbengê	Noun
ngbengë	Noun
ngbenzï	Noun
ngberere	Noun
ngbii	Adverb
ngbïngbï	Noun
ngbö	Adjective Noun
ngböbïtö	Adjective Verb Noun
ngbokoro	Adjective Verb Noun
ngbököröngö	Noun
ngbökua	Noun
ngbölïngö	Noun
ngbondâ	Adjective Noun
ngbondö	Adverb Adjective Noun
ngbondo	Verb
ngbondoma	Verb Noun
ngbonga	Adjective Verb Noun
ngbôngalö	Noun
ngbongbôro	Adjective Noun
ngböngô	Noun
ngbündängbü	Noun
ngbuta	Noun
ngê	Adjective
nge	Verb Noun
ngëdë	Adjective Noun
ngëmä	Noun
ngema	Verb
ngembö	Noun
ngemböwâ	Noun
ngendë	Noun
ngêngê	Noun
ngengerü	Verb Noun
ngëngö	Adjective Verb Noun
ngëngö-kë	Verb Noun
ngerë	Noun
ngêrë	Verb Adjective Noun
ngêrerê	Noun
ngete	Verb
ngëtö	Noun
ngîa	Adjective
ngîâ	Adverb Verb Adjective Noun
ngîâ-tângbi	Noun
ngîâkêma	Noun
ngîândeko	Noun
ngîkilê	Noun
nginza	Adjective Verb Noun
ngîra	Adjective Noun
ngira	Noun
ngîri	Verb
ngisë	Noun
ngise	Verb
ngö	Adjective Noun
ngô	Adjective Verb
ngo	Adjective Verb Noun
ngoalö	Noun
ngoangoa	Noun
ngôbo	Adverb Adjective Noun
ngoi	Preposition Adjective Noun
ngombe	Noun
ngömbo	Noun
ngonda	Noun
ngôndo	Noun
ngôngbi	Adjective Verb
ngôngbï	Noun
ngöngbïngö	Adjective
ngongo	Noun
ngöngonö	Noun
ngongote	Noun
ngonzä	Noun
ngonzo	Verb Adverb Adjective Noun
ngörö	Noun
ngoro	Verb Noun
ngôrôngbi	Verb
ngöröngbö	Noun
ngösimbä	Noun
ngötï	Noun
ngû	Adjective Noun
ngû-balë-ôko	Noun
ngû-îngö	Adverb
ngû-lâmba	Noun
ngubë	Verb Noun
ngûdädä	Verb
ngûên	Noun
ngûhîngö	Noun
ngûkua	Noun
ngûlê	Adjective Noun
ngûlëndë	Noun
ngûmba	Verb Noun
ngûmbömö	Verb
ngûme	Adjective Noun
ngundë	Noun
ngünde	Verb Noun
ngûndîmo	Noun
ngûngbi	Adjective Verb Noun
ngungu	Noun
ngûnzapä	Adjective Verb Noun
nguru	Adverb Adjective Verb Noun
ngûru	Noun
ngûrûngbi	Verb
ngürüngö	Noun
ngürüngö-ndo	Noun
ngusü	Noun
ngusüyätï	Noun
ngûterê-kôlï	Noun
ngûyenga	Noun
nguzü	Noun
nî	Preposition Connective Noun
nika	Verb Noun
Nïkpä	Noun
nïkpä	Noun
Nîli	Noun
nilöo	Noun
nînga	Adjective Verb Noun
nïngängö	Noun
nïväkîni	Noun
nivöo	Noun
Nizëre	Noun
Nizerïa	Noun
nôkpo	Verb
nökpöngö	Adjective Noun
nömörö	Adjective Noun
nörö	Noun
Nowêle	Noun
nyämä	Adjective Noun
nyama	Noun
nyâü	Verb Adjective Noun
nye	Adverb
nyekpawâ	Noun
nyenye	Noun
nyerë	Noun
nyïbâgara	Noun
nyïbokôo	Noun
Nyïbûku	Noun
nyïdeku	Verb Noun
nyïdödörö	Noun
nyïdongolomîso	Verb
nyïgäduru	Noun
nyïgbïä	Noun
nyïkatîsi	Noun
nyïkôndo	Noun
nyïkongä	Noun
nyïkpûlê	Noun
nyïmbo	Noun
nyïmêzä	Noun
nyïndû	Noun
nyïngäsa	Noun
nyïngûru	Noun
nyïpande	Verb Noun
nyïpâo	Noun
nyïpûsu	Noun
nyïtaba	Noun
nyïwâlï-taba	Noun
Nyïwanda	Noun
nyïyângâda	Noun
nyö	Verb Noun
nyöda	Noun
nyôfûta	Noun
nyöko	Noun
nyön	Verb
nyön-sämba	Verb
nyöngö	Verb Adjective Noun
nyöngö-sämba	Noun
nyotûngu	Noun
nyôwên	Noun
nzabï	Noun
nzämbö	Noun
nzambö	Noun
nzanga	Noun
nzângi	Noun
nzango	Noun
nzângo	Verb Noun
nzänzärä	Noun
nzanzë	Noun
Nzapä	Adjective Noun
nzapä	Adverb Adjective Noun
nzara	Adjective Noun
nze	Adjective Noun
Nzêen	Verb
nzêen	Verb Adjective Noun
nzêgê	Noun
nzelipë	Noun
nzên	Verb
nzënë	Adjective Noun
nzêngê	Adjective
nzengê	Adjective Noun
nzëngö	Noun
nzënngö	Verb Adjective Noun
nzerë	Adjective Verb Noun
nzere	Adjective Verb Noun
nzêrê	Noun
nzerë-ngara	Verb
nzërëngö	Verb Adjective Noun
nzërëngö-terê	Adverb Verb
nzêrerê	Noun
nzerëvonga	Noun
nzetï	Adjective Noun
nzï	Adjective Verb Noun
nzïä	Noun
nzînga	Verb
nzïngö-nyama	Noun
nzïngö-zo	Noun
nzö	Adjective Noun
nzöbä	Noun
nzöbê	Adverb Adjective Noun
nzökpälë	Noun
nzömbâgë	Noun
nzömbai	Adjective Noun
nzombö	Verb Noun
nzönî	Adverb Adjective Noun Interjection
nzönï	Noun
nzönî-bê	Noun
nzorôko	Adjective Verb Noun
nzötë	Verb Noun
nzöyê	Adverb Adjective Noun
ôke	Adverb
ôko	Adverb Adjective Noun
okü	Adverb Adjective
omenë	Adjective Noun
operëe	Verb
öpërëngö	Noun
oro	Verb
ôro	Verb
osïö	Adjective
osiyîri	Noun
otâ	Adverb Adjective Noun
ôtoro	Adjective Noun
pä	Verb Noun
pabuä	Noun
pagâno	Noun
pägâno	Noun
pagao	Adjective Noun
pagerê	Noun
paka	Adjective
pakapâka	Noun
pakara	Noun
pâke	Adjective Noun
päkoï	Noun
paläa	Noun
palaföon	Noun
palânde	Noun
pälänête	Noun
palâta	Noun
palî	Noun
palïi	Adjective Noun
Palïi	Noun
palüu	Adjective Noun
pâmbo-tï	Noun
pânda	Verb Noun
pandâfu	Noun
pandalöo	Noun
pandë	Adjective Noun
pande	Verb Noun
pandôo	Noun
pängä	Noun
pängö-ndo	Adverb Adjective Noun
panzëe	Noun
pâo	Noun
papa	Adjective Verb Noun
papäa	Noun
päpängö	Noun
papiri	Noun
päpü	Noun
pärä	Noun
pärä-gerê	Noun
paradonêe	Adjective Verb
paradöo	Noun
päsä	Adverb Adjective Noun
pâsä	Noun
päsagba	Noun
pasapöro	Noun
pasêe	Verb
päsëmä	Adjective Noun
päsëngö	Noun
pasetëre	Noun
pâsi	Adjective Noun
pasïöon	Adjective Noun
pasoära	Noun
paspartûu	Noun
pastêke	Noun
pata	Verb
patâ	Verb Noun
patapâta	Noun
pätärä	Noun
pawüngö	Adjective Noun
payôte	Noun
pë	Verb Noun
pëdâle	Noun
pedalêe	Verb
pekë	Noun
pekô	Noun Verb Preposition Adverb Adjective
pekôlö	Noun
pelênde	Noun
pelengü	Noun
pëli	Noun
pëlifa	Noun
pëlifâ	Noun
pëmbë	Adjective Noun
pendâ	Verb Noun
pendâkua	Noun
pendere	Adverb Adjective Noun
pëndïsîte	Noun
pëngö	Noun
pensöo	Noun
penze	Verb Noun
penzo	Adjective
pepese	Noun
pêrë	Noun
pere	Verb
përëmäa	Noun
peremïi	Noun
përëngö	Noun
përëngö-ndo	Adjective Noun
përësä	Noun
peresäa	Adverb Adjective
pêrête	Noun
pêrete	Noun
perezäa	Adjective Noun
pese	Noun
pêsi	Noun
pêsû	Noun
pëtë	Noun
pete	Verb
pëtëngö	Noun
petïzonyöon	Noun
piabâa	Verb
piakua	Noun
pialö	Noun
pïämë	Adjective Noun
pîâmê	Noun
piangêrë	Noun
piapa	Noun
pîdâ	Noun
pïdängö	Adjective
pîka	Adjective Verb Noun
pïkängö	Noun
pïkängö-bê	Adjective
pïkängö-kate	Verb Noun
pïkängö-lê	Noun
pïkängö-masïni	Noun
pïkängö-mbadi	Noun
pïkängö-ngû	Adjective
pïkängö-tênë	Adjective
pikâpu	Noun
pikëe	Verb Noun
pîli	Noun
pilîli	Noun
pilovëre	Noun
pïndïrï	Noun
pïndïrïwâ	Noun
pindo	Noun
pïnïi	Noun
piön	Verb Noun
pîpî	Noun
pîpï	Noun
pïrïwä	Adjective Noun
pïrïwâ	Noun
pïsï	Noun
pisîni	Noun
pisitöon	Noun
pitäan	Adjective Noun
pizamäa	Noun
pokô	Adjective
poko	Noun
polêlê	Adverb Adjective Noun
polïo	Adverb Noun
polöo	Noun
pomâde	Noun
pômbe	Noun
pombêe	Verb
pôme	Noun
pômetëre	Noun
pônde	Noun
pôngô	Noun
pöngö	Noun
ponö	Noun
pönzö	Adjective Noun
ponzö	Verb Noun
pönzö-tênë	Adjective Noun
popelîne	Noun
popö	Adjective Noun
pöpö	Preposition Adverb Adjective Noun
pöpö-hötö	Noun
popö-koba	Noun
pöpö-kubû	Noun
Pöpö-wërë	Noun
popökoba	Noun
popôto	Adjective
popoto	Verb
pôro	Adjective Noun
poro	Noun
pörö	Verb Adjective Noun
poroko	Adverb Adjective
porokotênë	Noun
pörölê	Noun
porosö	Adverb Noun
pöröterê	Noun
pöröyângâ	Noun
pöröyorö	Noun
Portugäle	Noun
pösä	Adjective Verb Noun
pösäïrï	Noun
pôse	Adjective
pôso	Noun
poso	Verb
poto	Verb Noun
potomonëe	Noun
potopôto	Noun
pozonë	Adjective Noun
pozonëe	Adjective
preavïi	Noun
puaröo	Noun
pûâvoro	Noun
puavoröon	Noun
püdere	Adjective Noun
pûdere	Verb Noun
pulä	Noun
pulûsu	Adjective Noun
pupëe	Noun
pupu	Preposition Adjective Noun
pupu-butu	Noun
pûpûlenge	Noun
purû	Adjective Verb Noun
purûnyama	Noun
puse	Adjective
pûsu	Verb Noun
pûsu-purû	Verb Noun
püsüngö	Noun
pûsupûsu	Noun
raböo	Verb Noun
radïo	Noun
radïokëkë	Noun
rakête	Noun
raköro	Noun
ramadäni	Noun
rambâi	Noun
râpe	Noun
rapêle	Noun
rêe	Noun
resïi	Noun
resöo	Noun
retêe	Verb
revëye	Noun
revolvëre	Noun
ridöo	Noun
rîsiki	Adjective Noun
robinëe	Noun
rôbo	Noun
rodâzi	Noun
rokôto	Verb Noun
rökötöngö	Noun
röngö	Adjective Noun
röngö-ngombe	Adjective
rôo	Verb Noun
rôze	Noun
rûmba	Noun
Rwanda	Noun
sâ-sombo	Verb Noun
Sâa	Noun
sâa	Noun
sâakilöo	Noun
sabäa	Noun
sabângo	Noun
sabûndu	Noun
Sâde	Noun
safû	Noun
Saharäa	Noun
saharawï	Noun
sahële	Adjective
Sahële	Adjective Noun
sâi	Noun
säkä	Noun
sâki	Noun
sâkikilöo	Adjective Noun
sâko	Adverb Verb Noun
sakôsi	Noun
sakpä	Noun
sakpa	Verb Noun
säkpängö	Adjective Noun
sakpëli	Noun
saläde	Noun
salöon	Noun
sämba	Noun
sambä	Noun
sambâ	Noun
sambêla	Verb Noun
sana	Verb
sândâga	Adjective Noun
sândâka	Noun
sandûku	Noun
sangbi	Verb
sângbi	Verb Noun
sangbilêgë	Noun
sangbingû	Noun
sangîâ	Noun
sängö	Adjective
sango	Noun
sängö-mênë	Noun
sangû	Noun
sânhîngö	Adjective Noun
sânkamënë	Noun
Sanzêe	Verb
sanzêe	Verb Noun
sänzëmä	Noun
sänzëngö	Noun
sänzëngö-lêgë	Verb
sânzîrî	Noun
sänzö	Adjective Noun
sao	Noun
sapâto	Noun
sapelê	Noun
säpëngö	Noun
sâra	Adverb Adjective Verb Noun
särä	Noun
Sâra	Verb
sara	Verb Noun
saragänïi	Noun
särängö	Verb Adjective Noun
särängö-ânge	Noun
särängö-fï	Noun
särängö-kua	Noun
särängö-li	Noun
särängö-mbänä	Verb
särängö-ngonzo	Noun
särängö-sânzîrî	Noun
särängö-yê	Adverb Verb Noun
saratëe	Adjective Verb Noun
sarawîsi	Noun
sarazäan	Noun
sarazêe	Adjective Verb Noun
sarazemäa	Verb Noun
sarazëre	Noun
sarïa	Noun
sariëre	Noun
sarzêe	Verb
sasa	Adjective Verb Noun
Säsëngö	Noun
saterê	Adverb Adjective Noun
sawâsi	Adjective Noun
sâyi	Noun
sê	Verb
së	Verb Noun
sê-zo-kûê	Adjective Noun
sêafrîka	Noun
sêbabâ	Adverb Noun
sêbasënzi	Adverb Noun
sêbê	Adjective Noun
sêbêndo	Noun
sêboro	Noun
sêbübä	Noun
sêbübängö	Noun
sêbüngbïngö-terê	Adverb
sêdïrïngö	Noun
sêdongô	Noun
sêdöngö	Noun
sêdüngö	Verb Noun
sêdüngö-ndê	Adjective
sêdütïngö	Verb Noun
sêesekûte	Noun
sefäa	Noun
sêfängö-zo	Adjective Noun
Sefetêne	Noun
sêforôto	Noun
sêgandïä	Noun
sêgbâ	Adjective Noun
sêgbânî	Noun
sêgbânzerë	Adjective
sêgbâtënë	Noun
sêgbemîngo	Adverb
sêgbendâmbu	Adjective
sêgbïä	Adverb Verb Adjective Noun
sêgbïä-halëzo	Adjective Noun
sêgbötöngö-yâ	Noun
sêgbüngö-hôn	Adjective
sêgbüngö-kokö	Noun
sêgësï	Noun
sêgindï	Noun
sêgiriri	Noun
sêgobo	Noun
sêgôkoï	Noun
sêhalë	Noun
sêhôn	Adjective Noun
sêkä	Noun
sêkäïngö	Noun
sêkâmâ-ûse	Noun
sêkamënë	Adverb Adjective Noun
sêkangba	Adjective Noun
sêkätölîki	Noun
sêkëngërë	Noun
sêkeretïen	Noun
sêkêtê	Noun
sêkêtêdû	Noun
sêkîbê	Noun
sêkïön	Noun
sêko	Adjective
seko	Noun
sêkodë	Noun
sêkodëkua	Verb Noun
sêkodëli	Noun
sêködörö	Noun
sêkoï	Adjective Noun
sêkôlï	Noun
sêköngö	Noun
sêkönöngö	Noun
sêkötä	Noun
sêkôzo	Noun
sêkpälë	Noun
sêkpengbä	Noun
sêkpëngbängö	Adjective
sêkpëngü	Noun
sêkperekpere	Noun
sêkpïngbängö	Adverb
sêkpô	Noun
sêkrîsto	Noun
sêku	Noun
sêküä-terê	Noun
sêkuasopo	Noun
sêkûne	Verb Noun
sêlê	Noun
sêlêgbïä	Noun
sêlêgë	Adjective Noun
sêlege	Noun
sêlêgô	Noun
selêka	Noun
sêlengbe	Noun
sêlëngö	Noun
sêlëngö-ngangü	Adjective
selerïi	Noun
sêlikisï	Noun
sêlimbambu	Adjective
sêlïngbïngö	Adjective Noun
sêlïngö	Noun
sêlombë	Noun
sêlöngö	Adverb Noun
sêlörö	Noun
sêlüküngö	Noun
sêmamâ	Adjective Noun
sêmängëngö	Noun
sêmarä	Noun
sêmatânga	Adjective Noun
sêmawa	Noun
sêmbäkôro	Noun
sembë	Noun
sêmbîndä	Adjective Noun
sêmbîrîmbîrî	Adverb
sêmboro	Noun
sêmbumbuse	Adjective
sêmênë	Noun
seminarïzi	Noun
sêmîngi	Noun
semîzi	Noun
sêmobimba	Adverb
sêmodô	Noun
sêmokondö	Noun
sêmôlengê	Adjective Noun
sêmüä	Adjective Noun
sêmvenî	Noun
sên	Noun
sêndâbambî	Noun
sêndâbätängö-susu	Noun
sêndâbê	Noun
sêndâdünîa	Verb Noun
sêndâfi	Noun
sêndâgao	Noun
sêndâkodë-da	Noun
sêndâkodë-yäkä	Noun
sêndâmâti	Noun
sêndânganga	Noun
sêndarä	Noun
sêndâsa	Noun
sêndâsaterê-limo	Noun
sêndâsêse	Noun
sêndâsû	Noun
sêndâterê	Noun
sêndâterê-wâlï	Noun
sêndâtûmbe	Noun
sêndâvêen	Noun
sêndâyê	Noun
sëndë	Noun
sëndëfûe	Noun
sêndere	Noun
senderëe	Adjective
sêndïä	Adverb Noun
sendikäa	Noun
sêndo	Adjective Noun
sêndowâ	Noun
sêndümbü	Noun
sêndurü	Verb Noun
sënë	Adjective Noun
senegâle	Noun
sênëngö	Noun
sênga	Adjective Verb
sêngangü	Adverb Noun
sêngangü-li	Adjective
sêngbâa	Noun
sêngbändä	Noun
Sêngbi	Noun
sêngbi	Verb Noun
sêngböbïtö	Noun
sêngbondö	Noun
sêngbongbôro	Adverb
sêngê	Adverb Verb Adjective Noun
sêngëdë	Noun
sêngëngö	Noun
sêngîâ	Noun
sëngö	Adjective Verb Noun
sëngö-bê	Noun
sêngonzo	Noun
sêngûnzapä	Noun
sênî	Adverb Adjective Noun
sênkëre	Noun
sënngö	Adjective Verb
sênömörö	Noun
sênyama	Adjective Noun
sênzapä	Noun
sênzêngê	Noun
sênzöbê	Noun
sênzönî	Noun
sênzorôko	Noun
sêôko	Noun
sepe	Verb
sepela	Verb
sëpëlängö-zo	Adjective
sêpêlê	Adjective
sêpenzo	Noun
sêpîtäan	Noun
sêpolêlê	Noun
sêre	Adverb Adjective Verb
serë	Noun
serême	Noun
seretifikäa	Noun
sereväan	Noun
sêrevoläa	Adjective Verb
sêsäkpängö	Adverb Adjective
sêse	Adverb Adjective Noun
sêse-mokönzi	Noun
sesêe	Adjective Verb Noun
sesêle	Noun
sêsêndâkua	Adjective
sêsêngê	Adverb Verb Noun
sêsïngö	Adjective Noun
sêsïnngö	Noun
sêsïönî	Adverb Adjective Noun
sêsïöyê	Noun
sêsîrîrî	Noun
sêsöngö	Noun
sêsüngö	Adjective Noun
sëtä	Adjective Noun
sêtâ	Noun
sêtaâ	Adjective Noun
sêtâbê	Noun
sêtambûla	Noun
sêtârârâ	Verb Noun
sëtë	Noun
sêtëngö-yê	Adjective Noun
sêterê	Adjective Noun
sêtîalïngbïngö	Adverb
sêtîambëtï	Noun
sêtîanzërëngö	Adjective
sêtôngbi	Verb
sevröon	Noun
sêvundü	Noun
sêvüngängö-sango	Adjective
sëwä	Adverb Adjective Noun
sêwane	Noun
sêwokölê	Noun
sêwököngö	Adverb Noun
sêyâgbê	Noun
sêyângâ	Adjective
sêyäpüngö	Verb Noun
sêyêgbâ	Noun
sêyeke	Noun
sêyêngbi	Noun
sêyêtara	Noun
sêyêterê	Noun
sêyigbo	Adverb Noun
sêzäkängö	Noun
sezariêne	Noun
sêzëndë	Noun
sêzo	Noun
sêzovukö	Noun
sha-sha-sha	Noun
shêne	Noun
sï	Connective Verb Noun
sî	Verb Noun
siföon	Noun
sïgî	Verb
sïgïgî	Verb Noun
sïgîgî	Verb Noun
sïgïngö	Noun
sîi	Noun
sîin	Adverb Verb
sikûte	Noun
simäa	Noun
simatêe	Verb
simbä	Noun
simba	Verb
sïn	Verb
sindimäa	Noun
sînga	Adjective
sîngâ	Noun
sïngä	Noun
sîngalê	Noun
sîngamê	Noun
sîngasûkô	Verb Noun
sîngatokua	Noun
singîla	Noun
sïngö	Adverb Verb Adjective Noun
sïngôme	Adjective Noun
Sîni	Noun
sïnngö	Adjective Noun
sïö	Adjective Noun
sïö-fünngö	Noun
sïöbê	Adverb Noun
sïögbïä	Adjective Noun
sïökodë	Adjective Noun
sïököngö	Noun
sïökpärï	Noun
sïöndo	Noun
sïöngähözo	Adverb Noun
sïöngoi	Noun
Sïönî	Adjective
sïönî	Adverb Adjective Noun
sïönï	Verb
sïönî-bê	Noun
sïönî-kua	Noun
sïönî-yângâ	Adjective
sïönï-yânga	Noun
sïönî-yê	Noun
sïönîyângâ	Noun
sïöpä	Adjective Noun
sïöpäsä	Verb Noun
sïöpêrë	Noun
sïösû	Verb Noun
sïötënë	Noun
sïöyängö-ïrï	Adjective
sïöyê	Adverb Adjective Noun
sïözonga	Verb Adjective Noun
sipö	Noun
sïrâze	Noun
sîre	Noun
sirêe	Verb
siri	Noun
sirîki	Noun
sîrîrî	Verb Noun
sisä	Noun
sisamî	Adjective Noun
sisato	Noun
sïsïbängö	Noun
sitatïi	Noun
sivîli	Adjective
siyöo	Noun
sö	Noun
so	Verb
Sô	Verb
sô	Verb Connective Adjective Noun
sobîsi	Noun
sofêe	Verb Noun
söfëngö	Adjective
Söfëngö	Adjective
söfëngö-ndo	Noun
sökö	Adjective Noun
sokoläa	Noun
sokporo	Noun
Somalïi	Adjective Noun
Somalîi	Noun
sombëe	Noun
sombêe	Verb
somêe	Noun
sömëngö	Noun
somëre	Noun
sön	Verb
söngö	Adverb Adjective Noun
söngö-bê	Noun
söngö-benda	Adjective Verb
söngö-li	Noun
söngö-mê	Noun
söngö-ngbângbâ	Noun
söngö-yâ	Noun
söngösëwä	Noun
sönngöta	Adjective Noun
sôo	Verb
sopo	Adverb Adjective Verb Noun
sörö	Adjective Noun
sorö	Noun
soro	Verb Noun
söröngö	Noun
söröngö-nginza	Noun
sosëti	Noun
sösö	Noun
sosotëe	Noun
su	Adjective Verb
sû	Adjective Verb Noun
sûâ	Adjective Noun
sua	Adjective Verb Noun
suali	Noun
süäli	Noun
süängö-mbîwâ	Noun
suatënë	Noun
süätënë	Noun
suazilânde	Noun
sudâni	Adjective
Sudâni	Noun
süîlîtiri	Noun
süîmêtere	Noun
suîya	Noun
sukâni	Adjective Noun
sûkô	Noun
sukongö	Noun
sûku	Adverb Verb Noun
sukûla	Adjective Verb Noun
Sukûla	Verb
sukûla-bongö	Noun
sukûla-sembë	Verb
sukûla-tatârâ	Noun
sükülängö	Noun
sükülängö-bongö	Noun
sükülängö-lê	Verb
sükülängö-ngû	Verb
sukûlu	Noun
sukuma	Verb
süküngö	Verb Adjective Noun
süküngö-ngbângbâ	Verb
sulêe	Verb
sülëngö	Noun
suliyëe	Noun
sümä	Adjective Noun
sümäsango	Noun
sumëe	Noun
sunamïi	Noun
sûndâ	Adjective Verb Noun
sungba	Adjective Verb Noun
sungbä	Noun
süngbängö	Verb Noun
süngö	Adverb Verb Noun
süngö-ïrï	Noun
süngö-ngbângbâ	Verb
süngöndö	Noun
sûnzilö	Adjective
sûpu	Adjective Noun
surä	Noun
sürä	Noun
sura	Verb
sûru	Adjective Verb Noun
sûrûngbi	Verb
sürüngö	Verb Adjective Noun
sürüngö-kûâ	Verb
sürüngö-yâ	Verb Noun
surûru	Noun
sûsê	Verb
susu	Adjective Verb Noun
susura	Verb
süsürängö	Noun
sutâni	Noun
suyêe	Verb
ta	Adjective Noun
tä	Verb
taâ	Adverb Adjective Verb Noun
taâtënë	Adjective Noun
taba	Adjective Noun
tabiliyëe	Noun
tâkâ	Adjective
tâkâpa	Noun
tâkâpande	Noun
tâkâzo	Noun
takisïi	Noun
täkôndo	Noun
tälêmbëtï	Noun
tälêngû	Noun
tambö	Noun
tambûla	Adjective Verb Noun
tämbülängö	Noun
tâme	Noun
tâmoro	Verb Noun
tanda	Verb Noun
tändängö	Noun
tanga	Adjective Verb Noun
tângbi	Adjective Verb Noun
tängbïngö	Adjective Noun
Tängbïngö-kua	Noun
tängbïngö-kua	Noun
tängbïngö-nzorôko	Noun
tangë	Noun
tângo	Noun
tantîne	Noun
Tanzanïa	Noun
täpandë	Noun
tapöo	Verb Noun
tarä	Noun
tara	Verb
tärängö	Noun
târârâ	Adverb Adjective
târâwârâ	Adjective
tasêse	Noun
tâsi	Noun
tasïön	Noun
tasombo	Noun
tatalîtä	Noun
tatärä	Noun
tatärälê	Noun
tate	Verb
tâtënë	Adjective Noun
tawâ	Noun
te	Verb Noun
têmbere	Noun
tëndëngbendë	Noun
tëndërëngö	Noun
tênë	Adjective Noun
tënë	Adjective Verb Noun
tene	Connective Adjective Verb Noun
tënë-lombë	Noun
tënëngö	Adjective
tënëngö-tënë	Noun
têngbi	Verb Noun
tëngbïngö	Verb Noun
tëngbïngö-terê	Noun
tengbö	Noun
tëngö	Adjective Noun
tëngö-kôbe	Noun
tëngö-lê	Verb
tëngö-yê	Noun
tëngö-zo	Noun
tenpäa	Verb Noun
terê	Adjective Verb Noun
tere	Verb Noun
terê-hötö	Noun
teregäle	Noun
teremôsi	Noun
terêngû	Noun
terête	Noun
tëtänôse	Noun
tetere	Verb
tezôon	Noun
tï	Adverb Adjective Verb Noun
tî	Noun Connective Verb Preposition Adverb Adjective
tîa	Verb
tîadïköngö	Adjective Verb
tîafünngö	Verb Noun
tîagbüngö-gerê	Adjective
tîagbüngö-kokö	Noun
tîagbüngö-li	Adjective Noun
tîahünzïngö	Adjective
tîakamënë	Noun
tîakasa	Adjective Noun
tîakëngö	Adjective
tîakongba	Noun
tîakpëngö-ndo	Adjective Noun
tîakua	Noun
tîalïngbïngö	Noun
tîalïngö	Adjective
tîamângbi	Adjective Noun
tîamängö-terê	Noun
tïängö	Verb Adjective Noun
tïängö-hânge	Noun
tïängö-kôbe	Verb
tïängö-kpô	Noun
tïängö-ndarä	Adjective
tïängö-pîka	Adverb
tïängö-vundü	Noun
tîangû	Adjective
tîanzara	Noun
tîanzërëngö	Verb
tîanzönî	Noun
tîasêboro	Noun
tîatëngö	Adjective
tiatïe	Verb
tiatïëre	Noun
tîâtio	Noun
tiatïo	Noun
tîawalö	Adjective
tîawëngö	Adverb Adjective
tîayämbängö	Verb
tiegege	Adverb Adjective Noun
tikëe	Noun
tîkîsa	Verb
Tïkïsängö	Noun
tîko	Verb Noun
timöon	Adjective Noun
tînga	Verb
tîngawâ	Noun
tïngö	Adjective Verb Noun
tïngö-yërë	Noun
tinîki	Noun
Tinizïi	Noun
tîo	Verb
tîpe	Noun
tipôi	Noun
tiri	Adjective Verb Noun
tirigöo	Noun
tirika	Verb
tirinitëe	Adjective Noun
tisä	Noun
tîsa	Verb
tîsângbi	Adjective Verb Noun
tïsängö	Noun
tïsängö-ndo	Adjective
tîsôro	Noun
tiyöo	Verb Noun
tiyöo-lida	Noun
tö	Adjective Verb Noun
tô	Noun
to	Verb
töbalabâla	Noun
töbuä	Adjective Noun
töbûngbi	Noun
töderê	Noun
tödükë	Noun
töfono	Noun
tögângbi	Noun
tögerêsû	Noun
Togöo	Verb Noun
tökôli-gbadara	Noun
tokua	Adjective Verb Noun
töküängö	Noun
töküängö-bängâ	Noun
tölambukä	Noun
tolï	Noun
tomba	Adjective Verb Noun
tomba-wandê	Noun
tömbängö	Verb Noun
tömbängö-wandê	Noun
tombôka	Adjective Verb Noun
tömbölö	Adjective Noun
tömolongö	Noun
töndâ	Verb
tondo	Verb Noun
tonga	Verb
töngana	Adverb Connective Adjective
töngasô	Adverb Preposition Connective Noun
tôngbi	Verb Noun
töngbïngö	Noun
töngbö	Noun
töngö	Adjective Noun
töngö-ndâ	Verb Noun
töngökôbe	Noun
tongolo	Noun
tono	Verb Noun
tönöngö	Noun
tönyöpulä	Noun
törö	Adjective Noun
tôrôrô	Adjective
tôrôsi	Noun
torôtorô	Adjective Noun
tosa	Verb
tötäsëmä	Noun
toto	Noun Verb Preposition Adverb Adjective
Tötöngö	Noun
tötöngö	Verb Adjective Noun
totoro	Verb
tôwâ	Noun
töwakua	Noun
töwâli-gbadara	Noun
töyângâda	Noun
töyëngö	Adjective Noun
tûâ	Adverb Verb
tuin	Adjective
tuke	Verb Noun
tükëngö	Adjective Noun
tukîâ	Noun
tukîa	Noun
tûku	Adjective Verb Noun
tüküngö	Noun
tulä	Noun
tula	Verb
tülängö	Noun
Tumba	Noun
tumba	Verb Noun
tümbängö	Noun
tungë	Noun
tüngë	Noun
tunge	Verb Noun
tungu	Noun
turûgu	Adjective Noun
turunêe	Verb Noun
türünëngö	Noun
türünëvîsi	Verb Noun
turûngu	Adjective Noun
tuta	Verb
tütängö	Adjective Noun
tutu	Verb
tutûu	Adjective
tuu	Adjective
Ugânda	Noun
üngö-yângâ	Noun
ûse	Adverb Adjective Noun
va	Adjective Noun
vâ	Verb
vaka	Noun
valäa	Adjective
vängö	Noun
vârä	Noun
vavara	Adverb
vävärä	Verb Noun
vekë	Noun
vêre	Noun
verenïi	Noun
veyëe	Noun
vîi	Noun
vîin	Verb
vinêgere	Noun
Vïngö	Noun
visêe	Verb
vîsi	Noun
vitamîni	Noun
vizäa	Noun
vo	Verb Noun
vonga	Adjective Noun
vongbâ	Noun
vöngö	Adjective Noun
vöngö-yê	Noun
voro	Adjective Verb Noun
vöröngö	Adjective Noun
vöröngö-ndo	Verb
vôte	Noun
vövö	Noun
vovoro	Noun
vü	Verb
vukö	Adjective
vûko	Verb
vukö-bê	Adverb Noun
vüköngö	Noun
vüköngö-ndo	Adverb
vülängö	Noun
vümä	Noun
vundû	Adjective Noun
vundü	Adjective Verb Noun
vunga	Verb
vûnga	Verb Noun
vüngängö	Adjective Noun
vurü	Adjective
vuru	Verb Noun
vurü-tutûu	Adjective Noun
vürüngö	Adjective Noun
Wa	Adjective
wa	Adjective Verb Noun
wä	Verb
wâ	Verb Adjective Noun
wâ(tî	Adjective
wa-ambiâsi	Verb
wa-angoläa	Noun
wa-azïi	Adjective
waâwa	Adjective
wababa	Noun
wabâda	Adjective
wabälëngö-ndo	Noun
wabânge	Noun
wabängö-sîngalê	Verb
wabärä	Noun
Wabäsïngö	Adjective
wabäsïngö	Noun
wabätängö	Noun
wabätängö-gbägbä	Noun
wabätängö-ngäsa	Noun
Wabekâni	Adjective Noun
wabêli	Noun
wabëlïzîki	Noun
wabenën	Noun
wabênyämä	Noun
wabibê	Noun
wabindi	Adjective Noun
wabïngö-wûrûwûrû	Noun
wabirä	Noun
wabôbô	Noun
waboma	Noun
wabongösêngê	Noun
wabösö	Noun
wabosö	Noun
wabübä	Adjective Noun
wabübängö-nginza	Verb
wabübängö-yê	Noun
wabûngbi	Noun
wabûti	Noun
wabüzë	Noun
wadädä	Noun
wâdädä	Verb
wadakängö-kôbe	Noun
wadambëtï-kötä	Noun
wadatëngö	Noun
wadëfängö	Noun
wadema	Noun
Wadema	Noun
wadëngösägbä	Noun
wadiabëte	Noun
wadibutïi	Noun
wadïköngö-mbëtï	Noun
wadïköngö-tënë	Verb Noun
wadïplômo	Noun
wadödô	Verb Noun
wadöngöngbïngö	Noun
Wadoroko-ndo	Noun
wadörököngö-ndo	Noun
wadubele	Noun
wadubere	Noun
waenä	Verb Noun
wafandarä	Adjective Noun
wafängö	Verb Noun
wafängö-lêkôbe	Verb
Wafängö-mênë	Noun
Wafängö-tënë	Noun
wafängö-terê	Noun
wafängö-yäkä	Adjective Verb Noun
wafängö-yê	Noun
wafängö-zo	Adverb Adjective
wafärä	Noun
wafarânzi	Noun
wafinön	Noun
wafono	Noun
wafôrôrô	Noun
wafûe	Noun
wafumbä	Noun
wafüngö-bongö	Noun
wafüngö-pörö	Noun
wafüngü	Noun
waga	Adverb Noun
wagabä	Verb Noun
wagaböon	Noun
wagalêsüä	Noun
wagambïi	Noun
wagana	Verb
waganäa	Noun
wagänngö	Verb Noun
wagao	Noun
wagapa	Noun
wagaratïi	Noun
wagarâzi	Noun
wagbadara	Adjective Noun
wagbâmbîngo	Noun
wagbâsênôn	Noun
wagbätä	Noun
wagbelê	Noun
wagbïngö-kâî	Noun
wagbötöngö-kâra	Verb
wagbötöngö-kutukutu	Noun
wagbüngö-kokô	Noun
wagbüngö-kokö	Verb
wagëndö-dûkûâ	Noun
wagerê	Adjective Noun
wagïängö-bê	Noun
wagindî	Noun
waginëe	Noun
Waginëe-Bisao	Noun
wagïngö	Noun
wagïngö-susu	Noun
wagïngö-tënë	Verb
wagino	Noun
waginon	Noun
wagio	Verb Noun
wagobo	Noun
wagôsinga	Noun
wagûâ	Noun
wagüëngö	Noun
wagügümä	Noun
wagümbä	Adjective Noun
wahâka	Noun
wahäkängö	Adjective Noun
wahâkolö	Noun
wahânda	Noun
wahândalê	Verb Noun
wahëngö-bîâ	Verb
wahëngö-pëmbë	Verb
wahëngö-zo	Noun
wahötö	Noun
wahümä	Noun
wahûnda	Noun
wakä	Noun
wakâmba	Noun
wakâmba-osïö	Noun
wakamënë	Noun
wakandöo	Verb Noun
wakânga	Noun
wakängängö-bê	Noun
wakängö	Noun
wakängö-kugbëmbëtï	Noun
wakängö-sâa	Noun
wakängö-tatärä	Verb
wakängö-wên	Noun
wakansëre	Noun
wakâpevêre	Noun
wakarapîri	Noun
wakaratëe	Noun
wakäsängö-ndo	Verb
wâkâwaka	Noun
wakëngö	Noun
wakëngö-vôte	Noun
wakeniyäa	Noun
wakêsi	Noun
wakîbê	Noun
wakifo	Noun
wakïngö	Adverb Verb Noun
wakïön	Adjective Noun
wakîrîkiri	Noun
wâkisi	Noun
wakobêla	Adjective
wakodë-masïni	Adjective
wakodëkua	Noun
Wakôdivoäri	Noun
waködörö	Noun
wakölêzi	Noun
wakômbe	Noun
wakomôro	Noun
wakônde	Noun
waköndö	Noun
waköngö	Noun
Wakongö	Noun
wakôtï	Noun
wakôto	Noun
wakôzo-düngö	Noun
wakpâda	Noun
wakpälë	Noun
wakpë	Noun
wakpê	Noun
wakpekpë	Noun
wakpëngö	Adverb Adjective Noun
wakpëngö-kpälë	Noun
Wakpëngö-kutukutu	Noun
wakpere	Noun
wakperekpere	Noun
wakpo	Noun
wakpoto	Noun
wakûâ	Adjective Noun
Wakua	Noun
wakua	Verb Adjective Noun
wakuasû	Noun
wakuate	Noun
waküdä	Noun
wakûku	Noun
wakünä	Noun
waküngbïngö-yê	Noun
wakürä	Noun
wakutukutu	Adjective Verb Noun
wala	Connective Noun
walafabëe	Noun
walaparä	Adverb Noun
walätërête	Noun
walêgë	Noun
walëkëngö	Noun
walëkëngö-sakpä	Noun
walëkëngö-tapïi	Noun
walëkërëngö	Adjective
walëkërëngö-lenge	Noun
walembë	Noun
walëngö	Adjective Noun
walëngö-ndo	Noun
walesuä	Noun
walësüä	Noun
walêyïndä	Noun
wâlï	Adjective Noun
walï	Noun
wâlï-bôi	Noun
wâlï-bokôo	Noun
wâlï-deku	Noun
wâlï-düngö	Noun
wâlï-hëngö-bîâ	Noun
wâlï-makâko	Noun
wâlï-ngäsa	Noun
wâlï-ngbä	Noun
wâlï-pagao	Noun
wâlï-taba	Noun
wâlï-wakua	Verb
Walïängö-ngû	Noun
walibêria	Noun
walibîi	Noun
wâlïdendöon	Noun
walikisï	Adjective Noun
walikundû	Noun
wâlïnyama	Noun
walitën	Noun
walö	Noun
walögbïä	Noun
walombë	Noun
walônzilö	Noun
walönzïngö	Adverb
waluemäa	Noun
walûku	Noun
walüküngö	Noun
walüngö-ndïä	Noun
walüngö-yê	Adjective
wamäbê	Verb Adjective Noun
wamäda	Noun
wamadagasikära	Noun
wamahuru	Noun
wamakoröo	Verb Noun
wamalï	Noun
wamamâ-danzapä	Adjective
wamandako	Adjective Verb
wamändängö-mbëtï	Verb
wamângbi	Noun
wamängbïngö	Adjective
wamängö	Adjective Noun
wamâpa	Noun
wamasûa	Noun
wamawa	Noun
wamayëre	Adverb Noun
wambadi	Noun
wambänä	Adjective
wambängö	Noun
wambârâtâ	Noun
wambere	Connective Noun
wambeto	Adjective Noun
wamëngö	Noun
wamörîsi	Noun
wamorôko	Noun
wamosoro	Verb Noun
wamoyayä	Adverb Verb Noun
wamozoko	Adverb Noun
wamüngö	Noun
wamüngö-kûngbâ	Verb
wamüngö-wâlï	Noun
wamvene	Noun
wamvulê	Noun
wanamibïi	Noun
wandânga	Noun
wandao	Noun
wandarä	Noun
wandaû	Noun
wandê	Noun
wandembö	Noun
wandimä	Noun
wandindïä	Noun
Wandokua	Noun
wandöli	Noun
wânga	Adjective Verb
wanga	Verb Noun
wängänä	Noun
wangana	Verb Noun
wanganga	Adjective Noun
wanganga-lê	Adverb
wanganga-pëmbë	Noun
wangangü	Noun
wangangü-li	Noun
wangangüli	Adjective Noun
wangböngï	Adverb Noun
wangëdë	Noun
wangëndë	Noun
wangêrë	Noun
wangîâ	Verb Noun
wängö	Noun
wangö	Noun
wangombï	Noun
wangonzo	Adverb Noun
wangû	Noun
wangûngbi	Noun
wanguru	Noun
wanî	Adverb Verb Adjective Noun
wanizerïa	Noun
wanyôfûta	Noun
wanyöngö	Adjective
wanza	Noun
wanzï	Noun
wanzïngö-nyama	Noun
wanzïngö-zo	Noun
wanzöbê	Noun
wanzönî	Noun
wapagao	Noun
wapalâta	Noun
wapânda	Noun
wapandë	Adjective Noun
wapängö-ndo	Verb
wapapa	Noun
wapäsä	Noun
wapâsi	Noun
wapelênde	Noun
wapëli	Noun
Wapëpinïëre	Noun
wapëtë	Noun
wapëtëngö-gôro	Verb
wapïämë	Adjective Noun
wapiâmê	Noun
wapîâmê	Noun
wapîdâ	Verb Noun
wapïkängö	Noun
wapïkängö-ndembö	Noun
wapïkängö-ngo	Verb
wapïkängö-pörö	Noun
wapïndïrïwâ	Adjective
wapöngö	Noun
wapôngô	Noun
wapöpö	Noun
wapörö	Noun
waporosö	Noun
wapulä	Noun
wapûsu	Noun
Wara	Verb
wara	Verb Noun
wârâga	Verb Noun
waranginza	Noun
wärängö	Noun
wärängö-yingö	Adjective
warenïon	Noun
waröngö	Noun
wäsâ	Noun
wasäkpängö	Adjective Noun
Wasäkpängö	Noun
wasänä	Noun
wasango	Adjective
wasärä	Noun
wasärängö	Verb Noun
wasärängö-limo	Adjective
wasärängö-ngîâ	Verb
wasêgbïä-halëzo	Noun
wasêgbïängangü	Noun
waselêka	Noun
wasêndâ-kodëkua	Noun
wasêndâdünîa	Noun
wasêndâgao	Noun
wasêndâterê-wâlï	Noun
wasêndâtûmbe	Adjective
wasëngö	Noun
wasêse	Noun
wasesêle	Adjective
wasêyângâ	Noun
wasimäa	Noun
wasimbä	Noun
wasîni	Noun
wasïöbê	Noun
wasïökörö	Adjective
wasïökpärï	Noun
wasïöpäsä	Noun
wasîrîrî	Verb Noun
wasomalïi	Adjective
wasöngö	Noun
wasöngö-benda	Noun
wasöngö-zo	Adverb
wasöngöta	Noun
wasopo	Verb Noun
wasöröngö	Noun
wasüngö	Noun
wasürüngö	Noun
wasurûru	Noun
watalâto	Noun
watambûla	Adjective Noun
watängbïngö-kua	Noun
watatalîtä	Noun
watatärälê	Noun
watatë	Noun
wate	Adjective Noun
watëndërëngö	Verb
watënë	Noun
watënëngö	Noun
watënëngö-mbai	Noun
watëngö	Adjective
watëngö-mî	Noun
watëngö-purû	Adjective
watîabiö-ngongo	Noun
watîalängö	Noun
watïngö	Noun
watipôi	Noun
watiri	Noun
wato	Verb Noun
watöfono	Noun
watogöo	Noun
watökua	Noun
watokua	Noun
watömbängö	Verb
watombôka	Verb
watondo	Verb Noun
watongolo	Adjective
watötäsëmä	Noun
watôwâ	Noun
watulä	Adjective
watülängö	Noun
wavöngö-yê	Verb
wavoro	Noun
wavöröngö	Noun
wavôte	Noun
wavülängö	Noun
wavundû	Noun
wavurübê	Noun
wâwa	Adverb Adjective
wawängö	Noun
wawärängö-yingö	Noun
wawërë	Noun
wawësë	Noun
wâyâ	Noun
Wayäkä	Noun
wayämbängö	Adverb Noun
wayângâ	Noun
wayângâ-ûse	Noun
wayângbö	Adjective Noun
wayëngö-bîâ	Adjective Noun
wayëngö-kua	Verb
wayërë	Noun
wayïndä	Adjective Noun
wayöngö	Noun
wayüngö-ndo	Noun
wazängö-yângâ	Noun
wazën	Noun
wazëndë	Noun
waziba	Noun
wazibä	Noun
wazidöo	Noun
wazonga	Noun
wên	Noun
wëngö	Adjective
wênngâ	Noun
wërë	Noun
werere	Noun
wese	Verb Noun
wësëngö-ndo	Adjective Noun
wisikïi	Noun
wo	Adjective Verb
wôgarä	Noun
wögbïä	Noun
wôko	Adjective Verb Noun
Wôko	Noun
wokölê	Adverb Adjective Verb
wököngö	Adjective Noun
wököngö-terê	Adverb Noun
wököngö-zo	Noun
wokoso	Verb
wökösöngö	Noun
wömba	Noun
wöngö	Noun
wöngö-terê	Noun
woro	Adjective Noun
wororo	Adjective Noun
wôtoro	Noun
woza	Verb
wü	Verb
wümä	Adjective Noun
wüngö	Adjective Noun
wüngö-gbä	Adjective
wüngö-ïrï	Adjective Verb Noun
wüngö-terê	Noun
wûrûwûrû	Adjective Noun
wûsûwusu	Adverb Verb Noun
wûyâwuya	Adjective
yâ	Adverb Adjective Verb Noun
ya	Verb Noun
yâ-döngö	Noun
yâ-kangû	Noun
yâ-ndo	Adjective
yâa	Verb
yâanëngö	Noun
yâda	Noun
yäkä	Adjective Noun
yâkongö	Noun
yamba	Adverb Adjective Verb Noun
yämbängö	Noun
yâmî	Adjective Noun
yângâ	Verb Adverb Adjective Noun
yângâ-ködörö	Noun
yângâ-kutukutu	Noun
yângâ-ngûhîngö	Adjective
yângâda	Noun
yângâködörö	Verb
yângângû	Noun
yangba	Noun
yängö	Noun
yängö-ïrï	Noun
yängö-li	Adjective Noun
yânî	Preposition
yäpakara	Noun
yâpapa	Noun
yâpu	Verb Noun
yäpüngö	Adverb Verb Adjective Noun
yäpüngö-terê	Noun
yâpupu	Adjective
yâpûsu	Noun
yârâde	Noun
yätï	Noun
yätï-kaküë	Noun
yâtîli	Noun
yayâ	Verb
yayû	Adjective
yäyû	Adjective Noun
yê	Adverb Adjective Verb Noun
yê-lüngö	Noun
yê-tângbi	Noun
yê-terê	Noun
yê-terê-kâsa	Verb
yê-tî-gô	Noun
yê-tî-mabôko	Noun
yê-tî-mê	Noun
yê-tî-ngîâ	Noun
yebe	Noun
yêgbâ	Adjective Noun
yêgbüngö	Noun
yegema	Verb
yêgïnïngö	Noun
yêkâ	Adverb Verb
yëkä	Verb Noun
yëkängö	Noun
yeke	Adverb Adjective Verb Noun
yekema	Adjective Verb
yëkëmängö	Noun
yekeyeke	Adverb Adjective Noun
yëkïängö	Noun
yëkpä-to	Adjective Noun
yêkpälë	Verb Noun
yêkua-gbïänngö-kpû	Noun
yêlïngbïngö	Adjective
yëmä	Verb Noun
yembere	Verb
yenga	Adjective Verb Noun
yëngängö	Noun
yêngbi	Adjective Verb
yëngbïngö	Noun
yêngê	Adjective
yênge	Verb Noun
yëngëngö	Adjective
yengere	Verb Noun
yêngi	Adverb Adjective Verb Noun
yëngïngö	Noun
yëngö	Noun
yëngö-da	Verb Noun
yëngö-ködörö	Noun
yëngö-nginza	Adjective
yëngö-pekô	Verb
yëngö-tënë	Noun
yëngö-terê	Adjective
yëngö-yê	Noun
yëngöda	Noun
yëngönî	Adjective Noun
yênyö	Noun
yênzapä	Noun
yênzerë	Noun
yêôko	Adverb
yërë	Verb Adverb Adjective Noun
yêsô	Noun
yêtatë	Adjective Verb
yetenäa	Noun
yêtonö	Noun
yêwözängö	Noun
yêyöröngö	Noun
yigbo	Adjective
yïmbängö	Noun
yïngïngö	Noun
yingö	Adjective Noun
yingö-vä	Noun
yo	Verb
yô	Verb
yö	Verb Noun
yökûngbâ	Noun
yolia	Verb
yölïängö	Noun
yömbö	Adjective Verb Noun
yongba	Verb
yöngbängö	Noun
yöngö	Adjective Verb Noun
yongo	Noun
yongôro	Preposition Adverb Adjective Noun
yongôro-etâzi	Noun
yongôro-koli	Verb
yongu	Noun
yôo	Verb
yôolê	Noun
yôro	Adjective Verb Noun
yorö	Verb Adjective Noun
yorölê	Noun
yorönden	Noun
yöröngö	Adjective Noun
yöröngö-terê	Verb
yoyä	Adjective
yoya	Verb
yöyängö	Noun
yôyô	Noun
yü	Adjective Verb Noun
yû	Verb Noun
yûma	Adjective
yüngö-ndo	Verb Adjective Noun
yuru	Verb Noun
yürüngö	Adjective Noun
yürüngö-gbikï	Adjective
za	Adjective Verb
zä	Verb Noun
zâboro	Adjective Noun
zâburu	Adjective Noun
zägbö	Verb Noun
zâka	Noun
zaka	Verb
zâkâli	Verb
zäkängö	Noun
zakara	Verb
zâkâri	Adjective Verb Noun
zakarima	Verb Noun
zäkête	Verb Noun
zalabîa	Noun
Zâmani	Noun
zambêzi	Noun
zambïi	Noun
zängö	Adjective Noun
zängö-ndo	Noun
zängö-tu	Noun
zängö-yângâ	Noun
zângûle	Noun
zarä	Adjective Noun
zâra	Verb Noun
zaradäa	Noun
zärängö	Adverb Noun
zâûza	Noun
zavokäa	Noun
zaza	Noun
zazama	Noun
zäzämä	Noun
zäze	Noun
zë	Adjective Verb Noun
ze	Noun
zêe	Verb
Zegbe-garâmo	Noun
Zegbe-mêtere	Noun
zema	Verb Noun
zembe	Noun
zen	Adjective Noun
zën	Verb Noun
zëndë	Adjective Noun
zêndo	Noun
zêne	Adjective Verb
zënëngö	Verb Noun
zëngö	Adverb Adjective Noun
zënngö	Noun
zepe	Verb
zere	Adverb Verb
zërëngö	Adverb Noun
zërëngö-zo	Noun
zerikäne	Noun
zezê	Noun
zî	Adjective Verb Noun
zï	Noun
zîa	Adverb Adjective Verb Noun
zïängö	Adjective Verb Noun
zïängö-bê	Adjective
zïängö-birä	Noun
zïängö-ïrï	Noun
zïängö-lêgë	Noun
zïängö-mênë	Verb
zïängö-ngonzo	Noun
zïängö-nzara	Adjective Noun
zïängö-wâ	Verb Noun
zibolatëre	Noun
zidöo	Noun
zîdoro	Noun
zigä	Adjective Noun
Zimbabüe	Noun
zîngbi	Noun
zingîri	Noun
zïngö	Verb Adjective Noun
zîngo	Verb Noun
zïngö-bê	Adjective
zïngö-bulöon	Verb
zïngö-gbâ	Noun
zîngo-hîo	Noun
zïngö-këkë	Noun
zïngö-kûtu	Noun
zïngö-lê	Noun
zïngö-lêgë	Noun
zïngö-sû	Noun
zïngö-tënë	Noun
zïngö-yâ	Noun
zîni	Noun
zinyöon	Noun
zîpe	Noun
zîpi	Noun
zîri	Verb
zîzëndë	Noun
zö	Adjective Verb Noun
zo	Adjective Verb Noun
Zo	Noun
zokëre	Adjective Noun
zolë	Noun
zoma	Noun
zonga	Adverb Adjective Verb Noun
zongere	Adjective Verb
zöngö	Adjective
zöngö-li	Verb Noun
zönî	Noun
zôon	Noun
zöon	Verb
zöröndö	Adverb Adjective Verb Noun
zorondo	Verb Noun
zovukö	Adjective Noun
zûâ	Noun
zuka	Noun
zûku	Verb
züngö	Noun
zûru	Verb
zuru	Verb Noun
zuruyara	Adjective
zûu	Verb Noun
