abe	Connective Adverb
abîdîbidi	Noun
âde	Adverb
ädïërä	Noun
âdu	Connective Preposition
âe !	Interjection
âe... !	Interjection
afirimëe	Noun
Afrîka	Noun
agîngî	Noun
ahön	Adverb
ahön ndönî	Adjective Adverb
akâ	Noun
âkä !	Interjection
akasiä	Noun
âla	Pronoun
ale	Connective Adverb
alê	Noun
ale !	Interjection
alêâmbû	Noun
alêbedê	Noun
alêgo	Noun
alêvu	Noun
alfakî	Noun
âlîâ	Noun
alîngbi	Adjective
alô verä	Noun
âmangêe	Adverb
ämbälä	Noun
ämbëlä	Noun
ambïängû	Noun
ambiâsi	Noun
Amerîka	Noun
ananâsi	Noun
andâa	Connective Adverb
ânde	Adverb
ândö	Adverb
ândyâ	Noun
angbökö	Noun
ânge	Noun Verb
angelëe	Noun
angirela	Noun
ängopê	Noun
angôro	Adverb
angôro	Adverb
angüründu	Noun
ânï	Noun Pronoun
ânyama	Noun
äpe	Adverb
äpë	Interjection
apolöo	Noun
ara	Verb
ara nyama	Verb
arâbu	Noun
ärängö	Noun
ärängö nyama	Noun
ärängö-zo	Noun
ârêge	Noun
aretêe	Verb
ärëtëngö-zo	Noun
ariköo	Noun
âroa	Noun
arozêe	Verb
ärözëngö-yê	Noun
arozoära	Noun
artikle	Noun
asa	Verb
äsängö	Noun
asï na	Preposition
asïäkulä	Noun
asingana … gbä sï …	Connective
âta	Noun
âta	Noun
atâa	Connective Adverb
atâa sô	Connective
âtarä	Noun
atorôni	Noun
aû	Noun
avâsi	Noun
ävërä	Noun
avïon	Noun
awe	Adjective
awôyangändê	Noun
awûyere	Noun
âyê tî âkötarä	Noun
ayungudi	Noun
ba	Adjective Verb
bä	Noun
ba na mbâgë	Verb
bâa	Verb
bâa biandö	Verb
bâa finön	Verb
bâa gïgî	Verb
bâa kobêla	Verb
bâa lê	Verb
bâa lê na kötä bê	Verb
bâa li	Verb
bâa mawa	Verb
bâa mbadi	Verb
bâa mo mû	Noun
bâa mosümä	Verb
bâa ndo	Verb
bâa nze	Verb
bâa nze awe	Verb
bâa nzönî	Verb
bâa pâsi	Verb
bâa sïönî	Verb
bâa tënë	Verb
bâa terê	Verb
bâa töngana	Verb
bâa zegë	Verb
bâa-mo-tene	Connective
bâan	Noun
bâar	Noun
baba	Noun
babâ	Noun
bâbâ	Noun
babâ-këtë	Noun
babâ-kötä	Noun
babango	Noun
bäbolo	Noun
badâ	Noun
bâda	Noun
bâdabûku	Noun
bâdahalëzo	Noun
bâgara	Noun
bâge	Noun
bakâ	Noun
bakarî	Noun
bâke	Noun
bäkenzä	Noun
bäkongö	Noun
bäkoyä	Noun
bäkpä	Noun
bäkürü	Noun
bala	Noun Verb
balabâla	Noun
balaka	Noun
balambo	Noun
balangëti	Noun
bälängö	Noun
bälängö-ndo	Noun
balaô	Noun
balapäa	Noun
bâlâwâ	Noun
bale	Noun
bale	Noun
balë gümbâyä na gümbâyä	
balë ôko	
balë ôko na gümbâyä	
balë ôko na mbâsâmbâlâ	
balë ôko na meambe	
balë ôko na ôko	
balë ôko na okü	
balë ôko na omenë	
balë ôko na osïö	
balë ôko na otâ	
balë ôko na ûse	
balë osïö na ûse	
balë otâ	
balë otâ na okû	
balë ûse	
balë ûse na ôko	
balë ûse na ûse	
balëe	Noun
balêe	Verb
balëe tî da	Noun
bälëngö-ndo	Noun
balima	Noun
bâlme	Noun
balöon	Noun
bämarä	Noun
bambâ	Noun
bambî	Noun
bambü	Noun
baminga	Noun
banda agi kûâ	Noun
banda pête	Noun
bânde	Noun
bandêe	Verb
bändëngö	Adjective Noun
banga	Noun
bängâ	Noun
bânga	Verb
bängängö	Noun
bangäpôrô	Noun
bângbi	Noun Verb
bängbïngö-yê	Noun
bânge	Noun
bängërëwä	Noun
bangi	Noun
bängö	Adjective Noun
bängö tënë	Noun
bängö terê	Noun
bängö-li	Noun
bängö-ndo	Noun
bängö-pâsi	Noun
bängö-yâ	Noun
bângû	Noun
banzakoro	Noun
bâô	Noun
bäö	Noun
baoyo	Noun
bärä	Noun
bara	Verb
bara Bokassa	Noun
baragâ	Noun
baramïi	Noun
bärängö	Noun
bärängö-ndo	Noun
barâsi	Noun
baravöo	Noun
baravöo!	Interjection
bäsëlïk	Noun
basënzi	Noun
bata	Verb
bata li	Verb
bata tënë	Verb
bata terê	Verb
batabâgara	Noun
batakangi	Noun
batakûngbâ	Noun
batame	Noun
batamonëe	Noun
bätängö	Noun
bätängö-nyama	Noun
bataterê	Noun
batêmo	Noun
batizêe	Verb
bawên	Noun
bäyürü	Noun
bazêngele	Noun
be	Adjective Verb
bê	Noun
bê adë	Verb
bê adö	Verb
bê anzere	Verb
bê apîka	Verb
bê aso	Verb
bê ayeke gï na ndüzü	Verb
bê azä wâ	Verb
be lê	Verb
bê ôko	Noun
bê-ndâmbo	Noun
Bêafrîka	Noun
bebe	Noun
bëbë	Noun
bëbërä	Noun
bêbï	Noun
bëgbëngë	Noun
bêkombïte	Noun
bëkpä	Noun
bêkü	Noun
bëlä	Noun
bêlâ	Noun
bela	Verb
bêläwü	Noun
bêli	Noun
bêliforôto	Noun
belü	Noun
bema	Verb
bëmängö	Noun
bemba	Noun
bembe	Verb
bëmbëngö-ndo	Noun
ben-görö	Noun
benda	Noun
bênde	Noun
bendêre	Noun
bêndo	Noun
bengbä	Adjective
bengbä dongô tî këkë	Noun
bengbä gbudu	Noun
bengbä kâdâ	Noun
bengbä-mê	Noun
bëngö	Adjective Noun
bênyämä	Noun
bere	Verb
bere terê	Verb
bërëngö-tënë	Noun
bëtä	Noun
bêtaâ	Adjective
betë	Noun
beterê	Noun
bezoä	Noun Verb
bï	Noun
bi	Noun Verb
bi bê	Verb
bi gbânda	Verb
bi na gîgî	Verb
bi na ndö	Verb
bi na ngû	Verb
bi pärä	Verb
bi tënë na li tî zo	Verb
bi tënë na ndö tî zo	Verb
bi tombôka na li tî zo	Verb
bi yângâ	Verb
bi yongô	Verb
bi zegë	Verb
bi zo na dû	Verb
bîâ	Noun
biakenge	Noun
bîakü	Adverb
bîakü bîakü	Adverb
biandö	Noun
bîanî	Adverb
bîanî bîanî	Adverb
bibê	Noun
biberöon	Noun
bîêre	Noun
bîki	Noun
bîkîsi	Noun
bîklo	Noun
bïkua ôko	Noun
bïkua okü	Noun
bïkua osïö	Noun
bïkua ötâ	Noun
bïkua ûse	Noun
bîlîbili	Noun
bilisa	Noun
bilômbï	Noun
bindi	Noun
bîndjô	Noun
bînga	Verb
bîngbi	Verb
bïngï	Noun
bïngö	Noun
bïngö na ngû	Noun
bïngö-bê	Noun
bïngö-gbânda	Noun
bïngö-yongô	Noun
bïngöpärä	Noun
binlï	Noun
biö	Noun
biö tî kate	Noun
biö tî lê tî këkë	Noun
biö tî li	Noun
biö tî nbgângbâ	Noun
biö tî susu	Noun
biögô	Noun
biökünï	Noun
biöngbângbâ	Noun
biöngongo	Noun
bipa	Noun
birä	Noun
bîrï	Adverb
birîki	Noun
biringi	Adjective
bîrîngi	Verb
bïrïngïngö	Noun
biriwo	Noun
birlo	Noun
biröo	
biröo	Noun
bîse	Noun
bisêe	Verb
bïsëngö-zo	Noun
bisikïï	Noun
bîye	Noun
bîye	Noun
biyô	Noun
bö	Verb
boâte	Noun
bobo	Noun
bôbô	Noun
böbötö	Noun
bôi	Noun
bôingû	Noun
bokôo	Noun
bolë	Noun
bolingo	Noun
bôlolo	Noun
bolongö	Noun
bölöngô	Noun
boma	Noun Verb
bömängö	Noun
bômö	Noun
böndö	Noun
bôndo	Verb
böndöngö	Noun
bôngô	Noun
bongö	Noun
bongö tî dë	Noun
bongö tî lango	Noun
bongö tî ngû	Noun
böngö-ndo	Noun
böngö-zo	Noun
bôon	Noun
boöroro	Noun
bôrô	Noun
börö	Noun
borû	Noun
bôso	Verb
bôsôngbi	Verb
bösöngbïngö	Noun
bösöngö	Noun
bôsuï	Noun
bôte	Noun
botêe	Verb
bötëngö	Noun
bôto	Noun
bôtö	Noun
boto	Noun
bôya	Noun
böyö	Noun
bozo	Adjective
bozö	Noun
bozo bozo	Adverb
bozö ti lakôro	Noun
bozö ti mbaza	Noun
bozö ti ngonzo	Noun
bozö-înön	Noun
bözömä	Noun
bozoma	Verb
bränzä	Noun
buä	Noun
buäkodë	Noun
buanga	Noun
bübä	Adjective Noun
buba	Verb
buba maseka wâlï	Verb
buba ngo	Verb
buba yâ	Verb
bübä-zo	Noun
bubangêrë	Noun
bübängö	Noun
bübängö-ngo	Noun
bübängö-yâ	Noun
bübängö-yê	Noun
bûbü	Noun
bûburû	Adjective Noun
bugûgümbä	Adjective
bûku	Noun
bulëe	Noun
bulu	Noun
buma	Noun
bûngbi	Noun
bûngbi	Verb
bûngbi terê	Verb
büngbïngö	Noun
burëte	Noun
bursayëe	Noun
burü	Noun
buruëti	Noun
buruma	Noun
burûnda	Noun
buruwïï	Noun
bûta	Noun
butöon	Noun
butu	Noun
butuma	Verb Adverb
bütümä-butuma	Adverb
büzë	Noun
buzïï	Noun
da	Noun
dä	Verb
da büzë	Noun
da kôbe	Noun
da tî etâze	Noun
da tî kânga	Noun
da tî kängö yorö	Noun
da tî längö	Noun
da tokua	Noun
daä	Adverb
dabambî	Noun
däbê	Verb
dädä	Noun
dadawâ	Noun
dadë	Noun
dâdömâa	Noun
dadüngö	Noun
däfö	Noun
dagbätä	Noun
dagbï	Noun
dagozo	Noun
dakêe	Verb
däkëngö	Noun
dakûku	Noun
dâlê	Noun
dalembë	Noun
dalimo	Noun
dalisorö	Noun
dämälöngö	Noun
damango	Noun
damâti	Noun
dambâ	Noun
dambâ-ngû	Noun
dambâgô	Noun
dambâkaola	Noun
dambârâtâ	Noun
dämbëtï	Noun
dandarä	Adjective Adverb
danditëe	Noun
danga	Noun
dangâlingâ	Noun
danganga	Noun
dangäsa	Noun
dangbâa-këlë	Noun
dängöbê	Noun
danzapä	Noun
därä	Noun
dara	Verb
daräa	Noun
därängö-yê	Noun
dasêndâgî	Noun
dasînga	Noun
daveke	Noun
dawäa	Preposition
dayorö	Noun
däzo	Noun
dê	Noun
de	Verb
dë	Verb
dë büzë	Verb
dë gapa	Verb
dë ïrï	Verb
dë kîte	Verb
dë köngö	Verb
dë ngbanga	Verb
dëbä	Verb
dëbê	Verb
dedêe	Adjective
dedêe nginza	Noun
degerëe	Noun
deke	Noun
deke	Noun
dëköngö	Noun
deku	Noun
deku tî ngonda	Noun
dekülüngü	Noun
dema	Verb
dema terê	Verb
dëmängö-terê	Noun
demarëre	Noun
dengbe	Noun
dênge	Verb
dênge lê	Verb
dênge mê	Verb
dênge terê	Verb
dëngëngö	Adjective Noun
dëngö	Adjective Noun
dëngö büzë	Noun
dëngö gapa	Noun
dëngö kîtë	Noun
dëngö köngö	Noun
dëngö-bä	Noun
dëngö-bê	Noun
dëngö-zo	Noun
depitêe	Noun
dere	Noun
dêre	Noun
dernayöo	Noun
dêro	Noun
dï	Verb
diamäan	Noun
didi	Noun
dïdïrï	Noun
didisînga	Noun
dîi	Noun
dîko	Verb
dîko tënë	Verb
dïköngö	Noun
dïköngö tënë	Noun
dïköngö-yê	Noun
dile-lîngbi	Noun
dïmïnïi	Verb
dïmïnïngö	Noun
dïngö	Noun
dinyä	Noun
diolo	Noun
diolö-sânga	Noun
dipîi	Preposition Adverb
dipîi sô	Preposition
dïplômo	Noun
dirï	Noun
diri	Verb
dïrïngö	Noun
dis-moi la vérité	Noun
disô	Adverb
do	Noun
dö	Noun
dö	Verb
dö dê	Verb
dö dödô	Verb
dö sêse	Verb
dö terê	Verb
dödö	Noun
dödô	Verb
dödörö	Noun
dôdôya	Noun
dogbo	Adjective Noun
dogbo-longaya	Noun
dogotöro	Noun
dokpa	Adjective
dokpâlâ	Noun
dola	Noun
doli	Noun
dôli	Verb
dolundîû	Noun
dombere	Noun
dôn	Noun
dôngbi	Verb
döngbïngö	Noun
dongi	Noun
dongô	Adjective Noun
döngö	Noun
döngö dê	Noun
döngö dödô	Noun
döngö sêse	Noun
dongô tî këkë	Noun
döngö-terê	Noun
dono	Noun
dönzö	Noun
dörmâne	Noun
doro	Verb
dörö	Verb
doroko	Verb
doroko zo	Verb
dörököngö	Noun
dörököngö-zo	Noun
doromäni	Noun
döröngö	Noun
dotîa	Noun
dû	Adjective Noun
du	Verb
dü	Verb
dü mvene	Verb
dü pärä	Verb
dû tî hôn	Noun
dû tî lê	Noun
dû tî mê	Noun
dû tî ngû	Noun
dû tî nyama	Noun
dû tî papa	Noun
dubêre	Noun
dudu	Noun
duduwâ	Noun
dukâni	Noun
dükë	Noun
dulëe	Noun
duma	Noun
dumbere	Noun
dungbä	Noun
dûngbângbâ	Noun
düngö	Noun
dûngu	Noun
dungusärä	Noun
dûnîa	Noun
dûpöröterê	Noun
dûsuma	Adverb
dûtambö	Noun
dutëe	Noun
dutï	Noun Verb
dutï na bêkü	Verb
dütïngö	Noun
dütïngö-ndê	Noun
dyânta	Adverb
dyodyo	Noun
ë	Pronoun
ëbë	Noun
ebele	Noun
edêe	Verb
ëdëngö	Noun
een	Adverb
ëkälïtïse	Noun
ekôlo	Noun
ekôlomâpa	Noun
eli	Noun
ëmblï	Noun
ên-en	Adverb
enä	Noun
endiri	Noun
enge	Noun
eni	Noun
ëpätîte	Noun
epëe	Noun
êrepêfu	Noun
êrkôdokâ	Noun
esânzi	Noun
ësë	Noun
eskûtu	Noun
espôre	Noun
estidïö	Noun
etäa	
ëvrë	Noun
fa	Verb
fa ïrï	Verb
fa lêgë	Verb
fa mbëtï	Verb
fa na gîgî	Verb
fa pekô tî tënë	Verb
fä sïökpärï na gîgî	Verb
fa tënë	Verb
fa terê	Verb
fa yê	Verb
fâa	Noun Verb
fâa bê	Verb
fâa ganzâ	Verb
fâa kä	Verb
fâa këkë	Verb
fâa lêgë	Verb
fâa na ganzâ	Verb
fâa na sîi	Verb
fâa ngbanga	Verb
fâa ngborô	Verb
fâa ngû	Verb
fâa nyama	Verb
fâa terê	Verb
fâa yäkä	Verb
fâa yânî	Verb
fadë	Adverb
fadë fadë	Adverb
fadë fadësô	Adverb
fadësô	Adverb
fâfâra	Verb
fäfärängö	Noun
fâka	Noun
fâla	Verb
fälängö yê	Noun
fambele	Noun
famïï	Noun
fandarä	Noun
fângbi	Noun Verb
fängbïngö	Noun
fängö	Noun
fängö ganzâ	Noun
fängö mbëtï	Noun
fängö ngbanga	Noun
fängö nyama	Noun
fängö tënë	Noun
fängö terê	Noun
fängö yäkä	Noun
fängö yê	Noun
fängö zo	Noun
fängö zo na ganzâ	Noun
fängö-biö	Noun
fängö-gerê	Noun
fängö-mabôko	Noun
fângungu	Noun
fânî	Noun
fânî mîngi	Adverb
färä	Noun
fara	Verb
farânga	Noun
farânzi	Noun
fatikêe	Verb
fêen	Noun
felëre	Noun
femba	Noun
fenêtere	Noun
fêti	Noun
fi	Verb
filantîse	Noun
filëre	Noun
fîlîme	Noun
filimêe	Verb
fîmbo	Noun
fïngö	Noun
finî	Adjective Noun
finî finî	Adverb
finî môlengê	Noun
finî sango	Noun
fîon	Noun
fîon tî yângâ	Noun
firigöo	Noun
flamboayäan	Noun
folendïgi	Noun
fombâ	Noun
fondo	Noun
föndo	Noun
fono	Noun Verb
fönöngö	Noun
fonôno	Noun
foôkânga	Noun
foro	Verb
föröngö	Noun
fôrôrô	Noun
forôto	Noun
fotöo	Noun
fu	Adjective
fû	Verb
fü	Verb
fü kä	Verb
fufû	Noun
fuku	Noun
fün	Verb
füngö	Adjective Noun
füngö-bongö	Noun
füngö-kä	Noun
fungulatëre	Noun
fünngö	Adjective Noun
fûru	Verb
fûru zo	Verb
fürüngö	Noun
fürüsä	Noun
fûta	Noun Verb
fûta külä	Verb
fütängö	Noun
futîi	Verb
fütïngö	Noun
fûu	Adjective Noun
ga	Noun
gä	Verb
gä kötä	Verb
gä lûmbâlumba	Verb
gä na	Verb
gä ndê	Verb
gä ndurü	Verb
gä ngangü	Verb
gä nzönî	Verb
gä sänzö	Verb
gä wên	Verb
gä zo	Verb
gaduru	Noun
gagambolö	Noun
gainako	Noun
gambula	Noun
gamvara	Noun
gamvulê	Noun
gän	Verb
ganapânde	Noun
ganapônde	Noun
gangiliöon	Noun
gängö	Noun
gängö nzönî	Noun
gängö-sänzö	Noun
gänngö	Noun
ganyêe	Verb
gänyëngö	
gänyëngö	Noun
ganzâ	Noun
gapa	Noun
garâ	Noun
gara	Verb
gâra	Verb
gärängö	Noun
gasa	Verb
gata	Noun
gatï	Noun
gatöo	Noun
gayo	Noun
gazôkombo	Noun
gazöon	Noun
gazuäle	Noun
gbä	Adverb
gbâ	Noun
gba	Verb
gbâ-ködörö	Noun
gbâbiöterê	Noun
gbadani	Noun
gbadera	Noun
gbado	Noun
gbadodo	Noun
gbadôra	Noun
gbägbä	Adjective Noun
gbagbâî	Noun
gbägbängö	Adjective
gbägbärä	Adjective Noun
gbagbara	Noun Verb
gbägbärängö	Adjective
gbâgburu	Adjective Adverb
gbâkâ-gbaka	Adverb
gbâkawâgbä	Noun
gbakô	Noun
gbâkûrû	Noun
gbakwaâ	Noun
gbalâka	Noun
gbämä	Noun
gbâmbëtï	Noun
gbamïngangü	Noun
gbândä	Adverb
gbändä	Noun
gbânda	Noun
gbândâ gbä	Adverb
gbândeke	Noun
gbängä	Noun
gbangambala	Noun
gbangaya	Noun
gbangba	Verb
gbängbängö	Noun
gbânî	Adverb
gbânzi	Verb
gbânzi lêgë	Verb
gbânzi na danganga	Verb
gbänzïngö lêgë	Noun
gbänzïngö na danganga	Noun
gbänzïngö yê	Noun
gbara	Verb
gbarabübä	Noun
gbärängö	Noun
gbari	Noun
gbätä	Noun
gbâu	Noun
gbâvaka	Noun
gbâzâ	Noun
gbâzâbängâ	Noun
gbe	Noun
gbë	Verb
gbë lïngö	Verb
gbe tî gerê	Noun
gbe tî ndüzü bongö	Noun
gbe tî yâ	Noun
gbë veke tî wâlï	Verb
gbeda	Noun
gbedê	Noun
gbêen	Verb
gbegô	Noun
gbegôbîâ	Noun
gbegôgbïä	Noun
gbêle	Noun
gbelê	Noun
gbelêgbïä	Noun
gbemïngo	Noun
gbën	Verb
gbene	Verb
gbënëngö	Noun
gbênga	Noun Verb
gbêngângbi	Verb
gbêngbi	Verb
gbëngbïngö	Noun
gbëngö	Noun
gbëngö veke tî wâlï	Noun
gbenî	Noun
gbënngö	Noun
gbenyôgbïä	Noun
gbêre	Noun
gberïn	Noun
gbeterêkate	Noun
gbetî	Noun
gbeyâ	Noun
gbeyângâ	Noun
gbï	Verb
gbï kâî	Verb
gbï zo	Verb
gbïä	Noun
gbîan	Verb
gbîanngbi	Verb
gbigbi	Noun
gbikï	Noun
gbïngö	Adjective Noun
gbïngö kâî	Noun
gbïngö pêrë	Noun
gbïngö zo	Noun
gbo	Noun
gbô	Noun
gbô	Verb
gbö	Verb
gbo ngû	Verb
gbogbo	Noun
gbôgbôlinda	Noun
gboklû	Noun
gbôko	Adjective Noun
gbôkolobô	Noun
gbokome	Noun
gbôkôrâ	Noun
gbongô	Noun
gböngö ngû	Noun
gboô	Noun
gböô	Noun
gbôo	Verb
gbôpâla	Noun
gbôto	Verb
gbôto gerê	Verb
gbôto kutukutu	Verb
gbôto mê	Verb
gbôto na hôn	Verb
gbôto ngû	Verb
gbôto ngû tî me	Verb
gbôto ôtoro	Verb
gbôto pupu	Verb
gbôto terê	Verb
gbötöngö	Noun
gbötöngö gerê	Noun
gbötöngö kutukutu	Noun
gbötöngö na hôn	Noun
gbötöngö ôtoro	Noun
gbötöngö terê	Noun
gbötöngö-pupu	Noun
gbôtoro	Verb
gbötöröngö	Noun
gbözögbö	Noun
gbû	Verb
gbû bê	Verb
gbû gerê	Verb
gbû kokö	Verb
gbû li	Verb
gbû ngangü	Verb
gbudu	Noun
gbudu-kêlê-ngiä	Noun
gbûgbû	Noun
gbugburu	Verb
gbugburu terê	Verb
gbügbürüngö	Noun
gbügbürüngö-terê	Noun
gbûkulugbû	Noun
gbûndo	Noun
gbüngö	Noun
gbüngö kökö	Noun
gbüngö li	Noun
gbüngö ngangü	Noun
gburuka	Noun
gbütängbü	Noun
gbutûnga	Noun
ge	Adverb
gë	Verb
gene	Noun
gëngö	Noun
gerê	Noun
gerë	Noun
gerê tî lâ	Noun
gerêmbëtï	Noun
gëtëgberë, hôngbâtî	Noun
gï	Adverb
gi	Verb
gi bê	Verb
gi kôlï	Verb
gi kûâ	Verb
gi li	Verb
gi nyama	Verb
gï sô	Adverb
gi susu	Verb
gi tënë	Verb
gi terê	Verb
gi wâlï	Verb
gi yângâ	Verb
gi yê	Verb
gia	Verb
gia	Verb
gîâ	Verb
gîângbi	Verb
gïängbïngö	Noun
gïängö	Noun
gigi	Noun
gîgî	Noun
gilêganzâ	Noun
gilisêe	Verb
gïlïsëngö	Noun
gingisali	Noun
gïngö	Noun
gïngö bê	Noun
gïngö nyama	Noun
gïngö susu	Noun
gïngö tënë	Noun
gïngö yângâ	Noun
gïngö yê	Noun
gio bê	Verb
gïöngö bê	Noun
gïrïlânde	Noun
gïrîpe	Noun
giriri	Adverb
girisa	Verb
girisa lêgë	Verb
gïrïsängö tî yê	Noun
gïrïsängö yê	Noun
gizamäa	Noun
gô	Noun
gö	Verb
gô da	Noun
gô tî bongö	Noun
gobo	Noun
godobe	Noun
gogoro	Noun
gogoro tî nginza	Noun
goigôi	Noun
gomo	Noun
gön	Verb
göndä	Noun
gonda	Noun
gônda	Verb
gonge	Noun
gongê	Noun
göngö	Noun
gönngö	Noun
gonzo-kongä	Noun
gôro	Noun
goro	Verb
göröngö	Noun
govoroma	Noun
goyâve	Noun
gôyongö	Noun
gozo	Noun
gü	Verb
gûâ	Verb
gûâgüä	Noun
güängö	Noun
güë	Noun
gue	Verb
gue kôgarâ	Verb
gue na gene	Verb
gue na ködörö	Verb
gue ndê	Verb
gûên	Noun
güëngö	Noun
gûga	Noun
guge	Verb
gügëngö	Noun
gügü	Noun
gügümä	Noun
gûî	Noun
guin	Noun
gulu	Noun
gumba	Verb
gümbängö	Noun
gümbâyä	
gündâ	Noun
gündâ tî tënë	Noun
gundu	Noun
gundu	Verb
gündüngö	Noun
güngö	Noun
gûp	Noun
gura	Noun
gürü	Noun
guru	Verb
gurûnful	Noun
gûsâ	Noun
gûsûlakërë	Noun
güsüyömbö	Noun
gûte	Noun
hä	Verb
hä yângâ	Verb
hâa	Verb
hâa zo	Verb
hâka	Verb
hâka bongö	Verb
hâka nëngö	Verb
hâka pekô	Verb
hâka terê	Verb
häkängö	Noun
häkängö nëngö	Noun
häkängö pekô	Noun
hakpa	Adjective
halë	Noun
halëzo	Noun
hän	Verb
hän	Verb
hânda	Noun Verb
hânda-yê-da	Adverb
händängö	Noun
hängö	Noun
hängö yângâ	Noun
hänngö	Noun
hänngo-lê	Noun
hâra	Verb
harâmo	Noun
härängö	Noun
harara	Adjective
hâriyâ	Noun
hârr	Adverb
hasa	Verb
häsängö	Noun
hë	Verb
hë bîâ	Verb
hë kêtê ngîâ	Verb
hë ngîâ	Verb
hë zo	Verb
helô	Adjective
helôkpû	Noun
hën	Verb
hënë	Noun
hëngö	Noun
hëngö bîâ	Noun
hëngö kêtê ngîâ	Noun
hëngö ngîâ	Noun
hëngö zo	Noun
hënngö	Noun
hînga	Verb
hînga äpe	Adverb
hînga maseka wâlï	Verb
hînga mo tene	Verb
hînga ndo	Verb
hïngängö mbëtï	Noun
hïngängö-ndo	Noun
hîngö	Noun
hîngö tî basënzi	Noun
hîni	Verb
hinika	Verb
hïnïkängö	Noun
hïnïngö	Noun
hînön	Noun
hîo	Adverb
hôle	Verb
hölëngö	Adjective Noun
hôlôlô	Adjective
hömba	Noun
hôn	Noun
hön	Verb
hön na ïrï	Verb
hön na ndö tî yingö	Verb
hön ndê	Verb
hön ndö tî	Verb
hôn tî bâgara	Noun
hôn tî doli	Noun
hôn-gerê	Noun
hônde	Verb
hônde terê	Verb
höndëngö	Noun
hônga	Verb
hôngbâtî	Noun
hönngö	Noun
hôntï	Noun
hötö	Noun
hü	Verb
hümä	Noun
hûnda	Noun Verb
hûnda ködä	Verb
hûnda ndo	Verb
hûnda yângâ	Verb
hûnda yê	Verb
hündängö	Noun
hündängö ndo	Noun
hündängö yângâ	Noun
hündängö yê	Noun
hüngö	Noun
hunu	Verb
hününgö	Noun
hûnzi	Verb
hünzïngö	Noun
hünzïngö kobêla	Noun
huru	Verb
hûru	Verb
hûru mê	Verb
hûru ngbângbâ	Verb
hûru yângâ	Verb
hûrûhûrû	Noun
huruka	Verb
hurukuzü	Noun
hürüngö	Noun
hüzü	Noun
ï	Pronoun
iin	Adverb
ikitëre	Noun
ïkütä-tendele	Noun
ina	Noun
ingôo	Noun
ïnziä	Noun
îpo	Adverb
ipöo	Noun
irä	Noun
ïrï	Noun
îri	Verb
îri ndo na	Verb
îri ngû	Verb
ïrï tï ködörö	Noun
ïrï tï nzapä	Noun
îri yê	Verb
îri zonga na ndö tî zo	Verb
ïrïngö	Noun
ïrïngö ndo	Noun
ïrïngö yê	Noun
îtä	Noun
îtä tî kôli	Noun
îtä tî wâli	Noun
ka	Adverb
kâ	Adverb
kä	Noun Verb
kä ngêrë	Verb
kä nginza tî wâlï	Verb
kä tî wâ	Noun
kâbî	Noun
käbinëe	Noun
kâbotô	Noun
kadâ	Noun
kâdâ	Noun
kâdâ-banda	Noun
kâdâ-langba	Noun
kâdâ-münä	Noun
kâdâ-ndoro	Noun
kâdâgölô	Noun
kafäre	Noun
kagâ	Noun
kâî	Noun
kâi	Verb
kâï !	Interjection
kâi kobêla	Verb
kâi kpô	Verb
käïngö	Noun
käïngö kobêla	Noun
kâkâ	Adjective Adverb
kâkâkâ	
kakaradengbe	Noun
kakaûka	Noun
kakaweyêe	Noun
kâke	Noun
käkëlë	Noun
kakö	Noun
kälä	Noun
kalambo	Noun
kalamêe	Verb
kälämëngö	Noun
kâlângbâ	Noun
kalê	Noun
kalêe	Verb
kälëngö	Noun
kalesöon	Noun
kâmâ	Noun
kâmâ tî gbïä	Noun
kâmâkîte	Noun
kâmâporosö	Noun
kamaräde	Noun
kamâsïö	Noun
kamâta	Verb
kämätängö	Noun
kâmba	Noun
kâmba tî bê	Noun
kâmba tî kânga na kä	Noun
kâmba tî tere	Noun
kâmba tî turûngu	Noun
kâmba tî yâ	Noun
kâmbakä	Noun
kâmbamênë	Noun
kambîri	Adjective Noun
kambisa	Noun
kämbûsu	Noun
kamême	Adverb
kamënë	Adjective Noun
kamïï	Noun
kanäna	Noun
kandâ	Noun
kandâa	Connective Adverb
kängä	Noun
kangâ	Noun
kângâ	Noun
kânga	Noun Verb
kânga bê	Verb
kânga kä	Verb
kânga lêge	Verb
kânga li	Verb
kânga ngû	Verb
kânga terê	Verb
kânga yângâ	Verb
kangale	Noun
kangali	Noun
kangamë	Noun
kângame	Noun
kängängö	Adjective Noun
kängängö bê	Noun
kängängö lêge	Noun
kängängö li	Noun
kängärä	Noun
kangaradia	Noun
kangazâmba	Noun
kangba	Adjective Noun
kängbä	Noun
kângbi	Noun Verb
kângbi terê	Verb
kângbi vundü	Verb
kängbïngö	Noun
kängbïngö yê	Noun
kangi	Noun
kängö ngêrë	Noun
kängö yê	Noun
kangoya	Noun
kangû	Noun
kangû tî wên	Noun
käni	Noun
kanivöo	Noun
kânnga	Noun
kansëre	Noun
kânyâ	Noun
känzërë	Noun
kâpä	Noun
kapï	Noun
kapïta	Noun
kapitäni	Noun
kapitûla	Noun
kâra	Noun Verb
kara	Verb
kara ngbûgu	Noun
kârâgorö	Noun
karakânzi	Adjective Noun
kârâkö	Noun
karambulëe	Noun
kärängö	Adjective
karapîri	Adjective
kârâte	Noun
karatûsi	Noun
karavâte	Noun
karëe	Noun
karïi	Noun
karkâs	Noun
kärôte	Noun
kâsa	Noun
kâsa	Noun
kasa	Verb
kâsa kôndo tî ngû	Noun
kâsa tî pëmbë	Noun
kâsâkâsâ	Adverb
käsängö ndo	Noun
kasiä	Noun
kate	Noun
katebongö	Noun
katikâti	Noun
katiri	Adjective
katra	Noun
kâwa	Noun
kawoya	Noun
kâya	Noun
kayëe	Noun
kazâka	Noun
ke	Verb
ke terê	Verb
ke yângâ	Verb
kêeyäkä	Noun
këkë	Noun
këkë	Noun
keke [kɛkɛ]	Noun
këkë tî bulëe	Noun
këkë tî fondo	Noun
këkë tî gû	Noun
këkë tî kâwa	Noun
këkë tî kpu	Noun
këkë tî kroä	Noun
këkë tî mângo	Noun
këkë tî mbëtï	Noun
këkë tî papâye	Noun
këkë tî süä	Noun
këkë tî zavokä	Noun
kêkêre	Noun
kêkerêke	Adverb
këkëwâ	Noun
kêki	Verb
këlä	Noun
këlëpä	Noun
ken	Verb
këngë	Noun
kengelibäa	Noun
kengî	Noun
këngö yê	Noun
këngö-terê	Noun
kenkelibäa	Noun
kënngö yê	Noun
kêre	Noun
kere yöngö	Noun
kere-kere	Adverb
kerebende	Adjective
kerekpâ	Noun
keremba	Noun
kêrênzê	Noun
kêrêrê	Noun
keresa	Noun
kêrêwere	Noun
kësë	Noun
kêsêkësë	Noun
keta	Noun
kêtê	Adjective Noun Adverb
kete	Noun
kêtê ködörö	Noun
kêtê kömändâ	Noun
kêtê môlengê	Noun
kêtê ngîâ	Noun
kêtê ngoi	Noun
kêtê sï	Adverb
kêtê-këkë	Noun
kêtêkä	Noun
kêtêkpen [kɛtɛpkễẽ]	Noun
kêtêsisä	Noun
kêtêsisamû	Noun
kêtêyangba	Noun
kî	Noun
kï	Verb
ki ngû	Verb
kiakia	Noun
kifo	Verb
kîkînon	Noun
kikiri	Noun
kilöo	Noun
kilôti	Noun
kîn	Verb
kînda	Noun
kinda	Verb
kindagozo	Noun
kïndängö	Noun
kinîni	Noun
kinîni ngbedede	Noun
kïnngö	Noun
kîo	Verb
kïön	Adjective Noun
kïön	Adjective Noun
kïöngö	Adjective Noun
kipêe	Verb
kïpëngö	Noun
kiri	Noun
kirî	Noun
kîri	Verb
kîri	Verb
kîri na gbenî	Verb
kîri na pekô	Verb
kîri tënë	Verb
kîri yângâ	Verb
kîrîkiri	Adjective Noun Adverb
kïrïngö	Noun
kïrïngö tënë	Noun
kîrö	Noun
kîro	Verb
kïröngö	Noun
kisêre	Noun
kisoro	Noun
kitâbo	Noun
kîte	Noun
kitêe	Verb
kïtëngö	Noun
kizamäa	Noun
kö	Verb
kô käpä	Verb
kö lê tî kôbe	Verb
kö na sêse	Verb
kö ndâ	Verb
koa	Noun
kobangongo	Noun
köbâye	Noun
kôbe	Noun
kobêla	Noun
kobêla tî makâko	Noun
kobêla tî pëmbë	Noun
kobêla tî tende ngbëndë	Noun
kobêla tî wâ	Noun
kôbôdawa	Noun
ködä	Noun
kodë	Noun
kodëkua	Noun
kodogoro	Noun
ködörö	Noun
ködörö-kömändä	Noun
ködörösêse	Noun
kofö	Noun
köförö	Noun
köfrâze	Noun
kôgarâ	Noun
kôgärâ tî kôlï	Noun
kôgärâ tî wâlï	Noun
kogbëne	Noun
kôgbïä	Noun
kökö	Noun
koko	Noun
kôko	Noun
kôkô	Noun
kokö	Noun
kôkôkô	Noun
kokolîko	Noun
kokolîoko	Noun
kokômbo, kofö, ängopê	Noun
koköo	Noun
koköo gôro, ôvûrû, toô kokpî	Noun
kokora	Noun
kokôro	Noun
kokôro	Noun
kolêe	Verb
kölëngö	Adjective Noun
kôlï	Noun
koli	Noun
kôlï na kôlï	Adverb
kôlïbâgara	Noun
kôlïgaduru	Noun
kôlïkôndo	Noun
kôlïmüä	Noun
kôlïndü	Noun
kôlïngäsa	Noun
kolîngo	Noun
kôlïnyama	Noun
kôlïtaba	Noun
kôlô	Noun
kölö	Noun
kolobô	Noun
kolobô tî dyodyo	Noun
kolôfîâ	Noun
kôlôköndïö	Noun
kôlökôtö	Noun
kolôngo	Noun
kolongo	Noun
komäa	Noun
kömändâ	Noun
kömândë	Noun
kömändêe	Verb
kömändëmä	Noun
kömändëngö	Noun
kombâ	Noun
kombâlibebe	Noun
kömbë	Noun
kombori	Noun
kombûka	Noun
kombüta	Noun
kömë	Noun
kömïnyön	Noun
komisëre	Noun
komiserïa	Noun
kömokönzi	Noun
kömüä	Verb
kônde	Noun
kondêe	Verb
kondêe na ndö tî	Verb
köndëngö	Noun
kôndo	Noun
kondo [kondo]	Noun
kondo [kɔndɔ]	Verb
köndôme	Noun
kôndôndo	Noun
köndöngö	Noun
kongä	Noun
konga	Verb
kongba	Noun
kongï	Noun
kongö	Noun
kôngô	Noun
köngö	Noun
köngö käpä	Noun
köngö lê tî kôbe	Noun
köngö ndâ	Noun
kongôbololo	Noun
kongodo	Noun
kongôyasika	Noun
konô	Noun
kono	Verb
kono yâ tî	Verb
könömï	Noun
könöngö	Noun
könöngö yâ tî	Noun
könöngö yê	Noun
konza	Noun
koôngäsa	Noun
kôpâ	Verb
köpäyôkä	Noun
kôpïä	Noun
kopo	Noun Verb
körnêle	Noun
körö	Noun
koro	Verb
kôro	Verb
korobô	Noun
kôrôbodyo	Noun
korôkongbä	Noun
korôkorô	Noun
kôrôkpo	Verb
körömëngë	Noun
köröngö	Adjective Noun
kôrongû	Noun
korôro	Noun
körösôl	Noun
kosêbo	Noun
kôsö	Noun
kötä	Adjective Noun
kötä bê	Adjective Noun
kötä bê tî kôbë	Noun
kötä bokôo	Noun
kötä dambëtï	Noun
kötä gbätä	Noun
kötä ködörö-kömändâ	Noun
kötä kömändâ	Noun
kötä ndäpêrêrê	Noun
kötä ndôngô	Noun
kötä ngâgö	Noun
kötä ngîâ	Noun
kôtä ngû	Noun
kötä pëmbë	Noun
kötä sembë	Noun
kötä zembe	Noun
kötä zo	Noun
kötä-buä	Noun
kötä-yingövä	Noun
kötäkörö	Noun
kötälâ	Noun
kötarä	Noun
kötï	
koti	Noun
kötï-buä	Noun
kôtïgbenyogbïä	Noun
kôto	Noun
köto	Noun
koto kêtê	Verb
koto kêtêkä	Verb
koto koto	Noun
koto kɔtɔ	Verb
kotomolängö	Noun
kötöngö	Noun
kotöon	Noun
kôtshe	Noun
kovöo	Adjective Noun
kôya	Noun
koyö	Noun
kôzo	Adjective Adverb
kôzogbenyogbïä	Noun
kôzonî	Adverb
kozonyömö	Noun
kpa	Noun
kpa	Verb
kpa terê	Verb
kpâa	Adverb
kpäbänzä	Noun
kpafondo	Noun
kpaka	Verb
kpäkängö	Noun
kpakâra	Noun
kpakara	Verb
kpäkärängö	Noun
kpakata	Noun
kpakatawâ	Noun
kpâkayâo	Noun
kpäkë	Adjective
kpäklö	Noun
kpakoro	Noun
kpakpa	Noun
kpäkpä	Noun
kpakpakpa	Adverb
kpakpo	Noun
kpäkpö	Noun
kpâla	Noun Verb
kpälë	Noun
kpâliyâ	Noun
kpâlîya	Noun
kpändä	Adjective
kpängäbä	Noun
kpangbala	Noun
kpangbara	Adjective
kpângbârâ	Adjective
kpängblämûsu	Noun
kpângi	Noun
kpângitï	Noun
kpängö terê	Noun
kparaka	Verb
kpârâköngö	Noun
kpâsâ	Verb
kpasâkärä	Noun
kpâshinyâ	Noun
kpâtyâ	Adverb
kpäya	Noun
kpäyämä	Noun
kpayama	Verb
kpazürü	Noun
kpë	
kpë	Noun Verb
kpë lörö	Verb
kpë zo	Verb
kpêe	Adjective Verb
kpekpêe	Adjective
kpënbgërë	Noun
kpêne	Adjective
kpêngba	
kpêngba	
kpëngbä	Adjective Noun
kpêngba	Verb
kpëngbä bê	Noun
kpëngbängö	Adjective Noun
kpëngö	Adjective Noun
kpëngö lörö	Noun
kpëngö zo	Noun
kpënzü	Noun
kpëpëmbë	Noun
kpere	Verb
kpere-kpere	Noun Adverb
kperema	Noun Verb
kpësisa	Noun
kpete	Noun
kpete-bâ	Noun
kpete-doli	Noun
kpete-onê	Noun
kpete-sêse	Noun
kpete-sömënï	Noun
kpëtîbiö	Noun
kpëtîli	Noun
kpîkara	Noun
kplatîsho	Noun
kpô	Adjective Adverb
kpo	Verb
kpo gobo	Verb
kpo molongö	Verb
kpo na kpo	Adverb
kpô ndîdro	Noun
kpo zo na mbênî yê	Verb
kpöka	Noun
kpökä	Noun
kpokerë	Noun
kpôkôto	Noun
kpôkpô	Noun
kpômongö	Noun
kpomwe	Noun
kpôndenren	Noun
kpongbo	Noun
kpöngö	Noun
kpöngö-kate	Noun
kpôngubü	Noun
kpoô	Adverb
kpôpa	Noun
kporo	Verb
kpöröngö	Noun
kpoto	Noun
kpotolo	Noun
kpu	Noun
kpû	Noun
kpu na kpu	Adverb
kpûbongö	Noun
kpûkpû	Noun
kpûngbö	Noun
kpûngbö [o]	Noun
kpûngubü	Noun
kpûpa	Noun
kpûrû	Noun
krotöon	Noun
kü	Verb
kü sörö	Verb
kua	Noun
kûâ	Noun
küä	Noun
kûâ tî	Adjective
kua tî ködörö	Noun
küä tî lê	Noun
kua tî letäa	Noun
küä tî li	Noun
kua tî manda	Noun
küä tî ndö tî lê	Noun
kua tï pitäan	Noun
küä tî terê	Noun
küä tî yângâ	Noun
kûâ tî zo	Noun
kuâkuâ	Noun
kuasînga	Noun
kubû	Noun
kubûkua	Noun
küdä	Noun
kudubôon	Noun
kûê	Adjective Adverb
kuëtï	Noun
kugbë	Noun
kugbë tî kâsa	Noun
kugbë tî ndene	Noun
kugbë tî nginza	Noun
kugbë tî parâta	Noun
kugbë-kpakpa	
kugbë-lavu	Noun
kugbë-ngbö	Noun
kugbë-ngû	Noun
kûi	
kûi	
kûi	Noun Verb
kûi na ndö tî yingö	Verb
küïngö	Noun
küïngö	Noun
küïngö tî lâ	Noun
küïngö-terê	Noun
kûkû	Noun
kûku	Verb
kukûli	Adjective
kûkulû	Noun
küküngö	Noun
kukûpe	Noun
kükürü	Noun
külä	Noun
kuli	Noun
kûma	Noun
kümäsëmä	Noun
kümäsëngö	Noun
kumâsi	Verb
kûmba	Noun
kumbämbä	Noun
kunda	Noun
kundâ	Noun
kundi	Noun
kûndû	Noun
kundu	Noun
kûndû	Noun
kundü	Noun
kündü	Noun
kûngbâ	Noun
kûngbâ tî ngêrë	Noun
kûngbâ tî pekô tî wâlïï	Noun
kûngbi	Verb
küngbïngö	Adjective Noun
kunge	Noun
küngö	Adjective Noun
küngö sörö	Noun
kungû	Noun
kûngûlûbä	Adjective
künï	Noun
kunî	Verb
kunî bê	Verb
künïngö	Noun
kupu	Noun
kuräan	Noun
kûrê	Noun
kürü	
kürü	
kürü	Adjective
kûrûkürü	Noun
kûsâ	Noun
kûsâ yuku	Noun
kusâra	Noun
kûsêre	Noun
kûsêre	Noun
küsü	Noun
kütä	Adjective
kuti	Noun
kutia	Noun
kûtu omenë	Adjective
kûtugerê	Noun
kûtûkutu	Adjective
kutukutu	Noun
kutulinge	Noun
kûtunêmbo, kunge, kutulinge, ayungudi	Noun
kûtûngbä	Noun
kuturu	Noun
kûtûrûkuturu	Adjective
kûyâa-sisä	Noun
lâ	Noun
lâ tî matânga	Noun
lâ wa	Adverb
laâ	Adverb
lâalä	Noun
lâambâtô	Noun
labatäni	Noun
labatoära	Noun
laböo	Noun
labôro	Noun
lafabëe	Noun
lafâi	Noun
lafandema	Noun
lägërëmä	Noun
lâi	Noun
lâkâtâ	Adjective Adverb
lakërë	Noun
lakerëe	Noun
lakôro	Noun
lakpängbä	Adjective Noun
lâkûê	Adverb
lâkûê lâkûê	Adverb
lâkûê sô	Adverb
lâkûi	Noun
lalêe	Verb
lälëngö	Noun
lamana	Verb
lämänängö	Noun
lamânde	Noun
lämätîsi	Noun
lamba	Adjective
lâmba	Adjective Noun
lâmbâ	Noun
lambôo	Noun
lambu	Noun
lamene	Verb
lamêre	Noun
lamêrêde	Noun
lamerïï	Noun
lamisïon	Noun
lando	Noun
langä	Noun
längä	Noun
langandö	Noun
lângara	Noun
längö	Noun Verb
längö na	Verb
längö na gîgî	Verb
längö nzara	Verb
längö sïönî	Noun
längöngö	Noun
lânî	Adverb
lantanäa	Noun
lâôko äpe	Adverb
laparäa	Noun
lapê	Noun
lâpôso	Noun
laramoära	Noun
larentrëe	Noun
lâsô	Adverb
lasöon	Noun
lätïä,	Noun
lavu	Noun
lâyenga	Noun
lê	Noun
lë	Verb
lê azä wâ mîngi	Verb
lë gbïä	Verb
lê ködörö	Noun
lê na lê	Adverb
lê tî këkë	Noun
lê tî kôbe	Noun
lê tî kokora	Noun
lê tî wâ	Noun
lêgë	Noun
lêgëôko	Adverb
lêgëôko töngana	Preposition Adverb
lëgô	Noun
leke	Verb
leke bê	Verb
leke bê tî sâra yê	Verb
leke tënë	Verb
leke terê	Verb
lëkëngö	Noun
lëkëngö bê	Noun
lëkëngö bê tî sâra yê	Noun
lëkëngö tënë	Noun
lëkëngö terê	Noun
lëkëngö yê	Noun
lekere	Verb
lëkërëngö	Noun
lekpa	Noun
lëlë	Noun
lele	Noun
lêle	Noun
lëlêü	Noun
lembë	Noun
lêmbëtï	Noun
lêmbïö	Noun
lëndâ	Noun
lêne	Noun
lêngäla	Noun
lêngatä	Noun
lêngbêlengbe	Adverb
lêngbi	Noun Verb
lëngbïngö	Noun
lêngboro	Noun
lenge	Noun
lëngö	Noun
lëngö gbïä	Noun
lengua	Noun
lêngüngü	Noun
lênze	Noun
lêre	Noun
lesöon	Noun
lesüä	Adjective Noun
lesua	Verb
letäa	Noun
li	Noun
lï	Verb
li mbômbô	Noun
li tî da	Noun
li tî gerê	Noun
li tî këkë	Noun
li tî mabôko	Noun
li tî ngû	Noun
libêbe	Noun
likëngë	Noun
likisï	Noun
liködörö	Noun
likongô	Noun
likundû	Noun
likünï	Noun
lili	Noun
lime	Noun
limëe	Verb
lïmëngö	Noun
limon	Noun
linda	Verb
lïndängö	Noun
lïndï	Noun
lïndïsa	Noun
lindo	Noun
lïngä	Noun
lingangü	Noun
lîngbi	Verb
lîngbi	Verb
lîngbi na	Verb
lïngbïngö	Noun
lïngbïngö-terê	Noun
lïngî	Noun
lïngö	Noun
lingö-sënë	Noun
lingö-zegbesa	Noun
lingû	Noun
lisorö	Noun
litï	Noun
lo	Pronoun
lô	Pronoun
lo sô wa	Pronoun
loköterëzamba	Noun
lokôto	Noun Verb
lökötöngö	Noun
lokpoto	Noun
lôlo	Noun
lombë	Noun
lömbö	Noun
lomboma	Verb
lomboma tënë	Verb
lömbömängö	Noun
lömbömängö tënë	Noun
lomëre	Noun
londo	Noun
löndö	Verb
löndö ködörö	Verb
löndö na	Verb
londo tî ngîâ	Noun
löndöngö	Noun
löndöngö bê	Noun
londotîläpärâa	Noun
lôngbi	Verb
lôngbi lö	Verb
lôngbi tënë	Verb
löngbïngö	Noun
löngbïngö tënë	Noun
lôngbô	Adjective Noun Verb
löngö	Adjective
longo	Noun
lônzi	Verb
lônzilö	Noun
lönzïngö	Noun
lôo	Noun
lörö	Noun
loryëe	Noun
lôso	Noun
lötï	Verb
lötïngö	Noun
lotö	Noun
lü	Verb
lü kûâ	Verb
lûbâ	Adjective
luba	Verb
lübängö	Noun
lübängö-yê	Noun
luêe	Verb
luemäa	Noun
lûgusa	Noun
luîli	Noun
lükû-nzöku	Noun
lûmbâlumba	Adjective
lûmbûlumbu	Adjective
lüngö	Noun
lüngö kûâ	Noun
lungûla	Verb
lungûla kobêla	Verb
lüngülängö	Noun
lüngülängö kobêla	Noun
lungûu	Noun
lurêe	Verb
lürëngö	Noun
lütï	Verb
lütïngö	Noun
lüzôle	Noun
ma	Noun
mä	Verb
ma	Verb Adverb Other
mä fîin	Verb
mä na bê	Verb
mä ndo	Verb
mä tënë	Verb
mä terê	Verb
mä yângâ	Verb
mabe	Noun
mäbê	Noun
mabôkê	Noun
mabôko	Noun
mabôko na mabôko	Adverb
mabôko tî bongö	Noun
mabôko tî këkë	Noun
mäda	Noun
mafûku	Noun
mafüta	Noun
mafüta tî wôtoro	Noun
magazäni	Noun
mâi	Verb
mäïngö	Noun
maka	Noun
makabo	Noun
makâko	Noun
makala	Noun
makandâ	Noun
makanisëen	Noun
makayâbo	Noun
makelâ	Noun
makelâ-mabê	Noun
makongö	Noun
makoröo	Noun
makûu	Noun
mâlegbängä	Noun
mâlegbïngö	Noun
malêvere	Noun
mälö	Noun
mamâ	Noun
mamâ tî bâgara	Noun
mamâ tî kêrêrê	Noun
mamâ tî ngo	Noun
mamâ-kêtê	Noun
mamâ-kötä	Noun
mamâ-kulûtu	Noun
mamakä	Noun
mamândiä	Noun
mamêre	Noun
mamïön	Noun
mamîwätä	Noun
manda	
mändä	Noun
manda	Verb
manda pekô tî	Verb
mandäa	Noun
mandako	Noun
mändängö	Noun
mändängö pekô tî yê	Noun
mändängö-yê	Noun
mandërë	Noun
manderîne	Noun
mändö	Noun
mânga	Noun
mânga tî hôn	Noun
mangbêlê	Noun
mângbi	Noun Verb
mängbïngö	Noun
mangbôkô	Noun
mangböngä	Noun
mangêe	Verb
mangênge	Noun
mängëngö	Noun
mângo	Noun
mängö	Noun
mängö tënë	Noun
mängö terê	Noun
mängö-ndö	Noun
mängö-yângâ	Noun
mangöo	Noun
manzêke	Noun
mâpa	Noun
mâpa na bêre	Noun
mapîâ	Noun
mapo	Noun
mapô	Noun
mâra	Noun
marä	Noun
märä	Noun
maräbongö	Noun
marädutï	Noun
marakanïï	Noun
marakêe	Verb
märäkëngö	Noun
marakûbu	Noun
marâra	Noun
märïâzi	Noun
Marie mä ndö	Noun
maro	Noun
mâsa	Noun
mâsarâgba	Noun
maseka	Noun
masia	Noun
masïni	Noun
masïni tî dëngö ngû	Noun
masïni tî sukûla bongö	Noun
masïni tî töngö kôbe	Noun
masöo	Noun
masûa	Noun
masüä	Noun
matabïsi	Noun
mâtâmâtâ	
matânga	Noun
matawâ	Noun
mateläa	Noun
matenge	Noun
mato	Noun
matungûlu	Noun
mawa	Noun
mawôya	Noun
mayëen	Noun
mayëre	Noun
mazindi	Noun
mbâ	Noun Pronoun
mbadi	Noun
mbâgë	Noun
mbâgë na mbâgë	Adverb
mbai	Noun
mbäîwa	Noun
mbâkêlê	Noun
mbäkôro	Adjective Noun
mbakpa	Noun
mbamba	Noun
mbambâ	Noun
mbâmbalï	Noun
mbambângû	Noun
mbâmbanï	Noun
mbâmbe	Noun
mbänä	Noun
mbanda	Noun
mbangana	Noun
mbângi	Noun
mbängü	Noun
mbanu	Noun
mbanza	Noun
mbârâtâ	Noun
mbârâtâ tî ngonda	Noun
mbäsä	Noun
mbâsala	Noun
mbâsâmbâlâ	
mbasêlî	Noun
mbätä	Noun
mbätä tî gbïä	Noun
mbawa	Noun
mbêâ	Noun
mbëlä	Noun
mbene	Noun
mbenga	Noun
mbëngë	Noun
mbengêne	Noun
mbëngü	Noun
mbëngu	Noun
mbênî	Adjective Adverb
mbênî äpe	Adverb
mbênî bîrï	Adverb
mbênî kêkerêke	Adverb
mbênî yê	Pronoun
mbênî zo	Pronoun
mbere	Noun
mbësä	Noun
mbësë	Noun
mbeso	Noun Adverb
mbëtï	Noun
mbëtï tî Nzapä	Noun
mbëtï tî wanganga	Noun
mbëtï-sagba	Noun
mbëtïgüpa	Noun
mbëtïkâpä	Noun
mbëtïsango	Noun
mbëtïsînga	Noun
mbeto	Noun Verb
mbeto asâra	Verb
mbêtroô, gerë, ebele	Noun
mbï	Pronoun
mbî	Pronoun
mbili	Noun
mbiliya	Noun
mbimba	Noun
mbîndä	Noun
mbïngo	Noun
mbïö	Noun
mbipa	Noun
mbîrîmbîrî	Adjective Adverb
mblâ	Noun
mbö	Noun
mbo	Noun
mbo tî ngonda	Noun
mboatën	Noun
mbokâ	Noun
mbôko	Verb
mbököngö	Adjective Noun
mbom	Noun
mboma	Noun Verb
mboma tî lê	Noun
mboma wâ	Noun
mbombi	Noun
mbômbô	Adjective
mbombo	Noun
mbômbôli	Noun
mbômbonzi	Noun
mbômo	Noun
mbômö	Noun
mbôndî	Noun
mböngä	Noun
mbongo	Noun
mböngö	Noun
mböngö-ngûlê	Noun
mböngö-yê	Noun
mbonzi	Noun
mbôo	Verb
mbôo ngûlê	Verb
mbôrô	Adjective
mborô	Noun
mborola	Noun
mbörörö	Noun
mbôsï	Noun
mbôtën	Noun
mbötö	Noun
mbotö	Noun
mbotombô	Noun
mbotomon	Noun
mböwâ	Noun
mboyö	Noun
mbreya	Noun
mbua	Noun
mbüä	Noun
mbükâkä	Noun
mbûki	Noun
mbula	Adjective Noun
mbulango	Noun
mbuli	Noun
mbulu	Noun
mbûlûndo	Noun
mbülüngbä	Noun
mbumbü	Noun
mbumbuse	
mbumbuse	Adjective
mbündü	Adjective Noun
mbünë	Noun
mbupa	Noun
mbûrü	Noun
mbürü	Noun
mbürü tî wâ	Noun
mburumbûru	Noun
mbürüsu	Noun
mbusu	Adjective
mbusu bongö	Noun
mbütü	Noun
mbutu, moyele	Noun
mbûu	Noun
mbûungâ	Noun
mbûyû	Noun
mê	Noun
me	Noun Connective Verb
më	Verb
më ngo	Verb
mêä	Noun
mëä	Noun
meambe	
meba	Noun
mebë	Noun
mëda	Noun
mekä	Noun
meka	Verb
mëkängö	Noun
mëkängö-yê	Noun
mekazë	Noun
melinâa	Noun
même	Adverb
memeka	Noun
memekangolo	Noun
mëndä	Noun
mênë	Noun
mene	Verb
mênë tî këkë	Noun
mënëngö	Noun
mënëzîte	Noun
mëngä	Noun
mëngä asï yângâ	Verb
mëngäwâ	Noun
mëngö	Noun
mëngö ngo	Noun
meniziëe	Noun
meredëe	Verb
mërëdëngö-ndo	Noun
mêse	Noun
metï	Verb
mëtïngö	Noun
meya	Noun
mêzä	Noun
mi	Noun
mî	Noun
mï	Verb
midïi	Noun
midöon	Noun
mîfi	Noun
mii	Noun
mïmi	Adjective
mimîi	Adjective
mina	Verb
minängö	Noun
mîngi	Adjective Noun Adverb
mîngi nî	Adverb
mïngö	Noun
mîngo	Verb
mïngöngö	Noun
mini	Noun
minimîni	Noun
mino	Noun
mînyerë	Noun
mîon	Verb
mion	Verb Adverb
mïönngö	Noun
mîro	Verb
mïröngö	Noun
mîsa	Noun
mîsahînön	Noun
mîtâ	Adjective
mîterê	Noun
mîtigôro	Noun
mo	Pronoun
mô	Pronoun
mo-bâa-mo-tene	Connective
mobäbä	Noun
mobai	Noun
mobämbu	Noun
mobango	Noun
môbängö	Noun
mobärä	Noun
mobeli,	Noun
mobimba	Adjective
mobôndô	Noun
mobüä	Noun
mokandâ	Noun
mokêla	Noun
mokelele	Noun
mokengë	Noun
mokërëlö	Noun
mokili	Noun
môkö kârâkö	Noun
môko ndôngbâ	Noun
môko sângôo	Noun
mokobe	Noun
môkömbilî	Noun
mokondö	Adjective Noun
mokönzi	Noun
mokönzi-garâ	Noun
mokönzi-gbätä	Noun
mokopête	Noun
mokornëe	Noun
mokpäkpä	Noun
mokükutä	Noun
môlengê	Noun
môlengê kôlï	Noun
môlengê tî kôndô	Noun
môlengê tî mamîwätä	Noun
môlengê tî ngbökorö	Noun
môlengê tî nzapä	Noun
môlengê wâlï	Noun
molôbilômbï	Noun
molölömë	Noun
molongö	Noun
molôzanäna	Noun
mombändä	Noun
mombângo	Noun
mombangô	Noun
mombülü	Noun
momvê	Noun
mondêe	Verb
möndëngö	Noun
monderepâko	Noun
môndoro	Noun
mongâmba	Noun
mongbë	Noun
mongböngö	Noun
mongembêngêmbë	Noun
môngôdë	Noun
möngöli	Noun
môngûânyë-nzaï	Noun
môngûâyë	Noun
monya	Noun
monzanzara	Noun
monzëngä	Noun
mopï	Noun
mopîâ	Noun
mopiti	Noun
morenga	Noun
mosenyëre	Noun
mosïngä	Noun
mosôba	Noun
mosomë	Noun
mosongôli	Noun
mosoro	Noun
mosûlupita	Noun
mosümä	Noun
motarä	Noun
motete	Noun
mötökôo	Noun
motöo	Noun
motüä	Noun
movünguba	Noun
moyayä	Noun
moyele	Noun
moyûmba	Noun
mozëre	Noun
mozoko	Noun
mû	Verb
mü	Verb
mû avâsi	Verb
mû bîâ	Verb
mû fotöo	Verb
mû gô	Verb
mû ködä	Verb
mû kôlï	Verb
mû kôlï na	Verb
mû lêgë	Verb
mû lörö	Verb
mû mabôko	Verb
mû mbûki	Verb
mû ndo	Verb
mû ngîâ	Verb
mû ngo	Verb
mû pardöon	Verb
mû pekô tî	Verb
mû singîla	Verb
mû susu	Verb
mû terê	Verb
mû terê na	Verb
mû wâ	Verb
mû wâlï	Verb
mû wâlï na	Verb
mû wängö	Verb
mû yângâ	Verb
mû zegbesa	Verb
mû zëndo	Verb
mû-na-mbï	Noun
müä	Noun
muen	Noun
mümänä	Noun
mumana	Verb
mümänängö	Noun
münä	Noun
müngä	Noun
mûngâ	Noun
mûngbi	Noun Verb
müngö	Noun
müngö avâsi	Noun
müngö fotöo	Noun
müngö gô	Noun
müngö kôlï	Noun
müngö lêgë	Noun
müngö lörö	Noun
müngö mabôko	Noun
müngö mbûki	Noun
müngö ndo	Noun
müngö ngîâ	Noun
müngö pardöon	Noun
müngö pekô	Noun
müngö singîla	Noun
müngö susu	Noun
müngö wâ	Noun
müngö wâlï	Noun
müngö wängö	Noun
müngö yângâ	Noun
müngö-bataterê	Noun
müngö-terê	Noun
mûngûâä	Noun
munzû	Noun
munzû vokö	Noun
munzûnzapä	Noun
mûpe	Noun
mûrû	Noun
mustikëre	Noun
mve	Noun
mve tî masûa	Noun
mvele	Noun
mvene	Noun
mvenî	Adjective Noun Pronoun
mvesû	Noun
mvitasïon	Noun
mvönkëkë	Noun
mvuge	Noun
mvuka	Noun
mvupo	Noun
na	Connective
na	Preposition
na bê nî	Adverb
na bê ôko	Adverb
na bê tî	Preposition
na bê ûse	Adverb
na ga nî	Adverb
na ga tî	Preposition
na gatï	Adverb
na gatï tî	Preposition
na gbe tî	Preposition
na gbe tî lê tî	Preposition
na gbelê tî	Preposition
na gbemïngo	Adverb
na gbenî	Adverb
na gîgî	Adverb
na höndëngö nî	Adverb
na hüzü	Adverb
na kötï	Adverb
na kötï tî	Preposition
na lê nî	Adverb
na lê tî	Preposition
na lê tî âzo	Adverb
na lêgë nî	Adverb
na lêgë tî	Preposition
na lörö	Adverb
na mabôko tî	Adverb
na mawa	Adjective
na mbâgë	Adverb
na mbâgë tî	Preposition
na mbänä	Adverb
na ndâ nî	Adverb
na ndâ tî	Preposition
na ndembë sô	Adverb
na ndo kûê	Adverb
na ndö nî	Adverb
na ndo sô	Adverb
na ndo tî	Preposition
na ndö tî	Preposition
na ndo wa	Adverb
na ndüzü	Adverb
na parâsi nî	Adverb
na parâsi tî	Preposition
na pekô	
na pekô	Adverb
na pekô tî	Preposition
na pöpö nî	Adverb
na pöpö tî	Preposition
na sê nî	Adjective Adverb
na sê tî	Preposition
na sêse	Adjective Adverb
na terê nî	Adverb
na terê tî	Preposition
na yâ nî	Adverb
na yâ tî	Preposition
na yängäda	Adverb
naâmon	Noun
näbâke	Noun
nabändurü	Noun
nâkö	Noun
nanäa	Noun
nâpo	Noun
nawe	Noun
ndâ	Noun
ndâbâ	Noun
ndâbîâ	Noun
ndäbongofä	Noun
ndadë	Noun Adverb
ndägärä	Noun
ndâgerê	Noun
ndâgô	Noun
ndakândoko	Noun
ndâkî	Noun
ndaktambêyarï	Noun
ndâli	Noun
ndâli tî	Connective Preposition
ndâli tî nye	Connective Adverb
ndâmasûa	Noun
ndâmbo	
ndâmbo gbâzâ	Noun
ndâmbo kôlï	Noun
ndâmbo wâlï	Noun
ndâmbongû	Noun
ndângâ	Noun
ndânga	Verb
ndângängä	Noun
ndängängö	Noun
ndângbâ	
ndangi	Noun
ndânî	Noun
ndânî nye	Adverb
ndânî sô	Connective
ndäpêrêrê	Noun
ndârâ	Adjective Noun
ndarä	Noun
ndârâkpû	Noun
ndaramba	Noun
ndârârâ	Adverb
ndâsêse	Noun
ndâsû	Noun
ndawo	Noun
ndâyenga	Noun
ndê	Adjective Adverb
ndefi	Noun
ndeke	Noun
ndeke tî bâgara	Noun
ndeke tî kôndo	Noun
ndeke tî ngbä	Noun
ndeke-lûka	Noun
ndekêlendê	Noun
ndeko	Noun
ndeko	Noun
ndeko	Noun
ndeko	Noun
ndekoro	Noun
ndekozändë	Noun
ndembë	Noun
ndembö	Noun
ndembö tî gerê	Noun
ndembö tî nzângi	Noun
ndën	Noun
ndêndïä	Noun
ndënë	Noun
ndêngê	Adjective
ndêngê na ndêngê	Adjective
ndepandäa	Adjective Noun
nderere	Adverb
ndewa	Noun
ndiä	Noun
ndiäbïngo	Noun
ndîâkâni mblanga	Noun
ndiâlïpë	Noun
ndiäyângâ	Noun
ndiba	Noun
ndîdro	Noun
ndikâ	Noun
ndima	Noun
ndimä	Noun
ndindïri	Noun
ndiri	Noun
ndïrï	Noun
ndjûkuyû	Noun
ndo	Noun
ndö	Noun Adverb
ndo tî bângö ânyama	Noun
ndö tî gô	Noun
ndö tî lê	Noun
ndö tî mabôko	Noun
ndo wa	Adverb
ndöbê	Noun
ndöbê	Noun
ndögô	Noun
ndoî	Noun
ndokôro	Noun
ndokua	Noun
ndokua tî sango	Noun
ndölê	Noun
ndôli	Noun
ndölö	Noun
ndölö	Noun
ndömbâ	Noun
ndömbälê	Noun
ndombe	Noun
ndombö	Noun
ndömö	Adjective Noun
ndondöli	Noun
ndonga	Noun
ndöngâ	Noun
ndöngërë	Noun
ndongere	Verb
ndôngô	Noun
ndôo	Noun
ndörö	Noun
ndoro	Noun Verb
ndörö-kä	Noun
ndösëndë	Noun
ndötï	Noun
ndoto	Noun
ndowâ	Noun
ndöyê	Noun Verb
ndöyëngö-zo	Noun
ndü	Noun Verb
ndu	Verb
ndua	Noun
ndûkû	Noun
ndûkûkôta	Noun
ndûkunyâan	Noun
ndûmbâ	Noun
ndümbü	Adjective Noun
ndûnda	Noun
ndüngö	Noun
ndurü	Adjective Noun Adverb
ndûru	Adjective Verb
ndûrü	Noun
ndurü na	Preposition
ndurü ngbonga	Noun
ndurü ngombe	Noun
ndurü sümälisorö	Noun
ndurü tî	Adjective
ndûrûkpâ	Noun
ndürüngö	Noun
ndurüsû	Noun
ndüzü	Noun
ndüzü bongö	Noun
ndyîkîlî	Adjective
ndyömbë	Noun
ndyongo	Noun
ne	Verb
ne zo	Verb
nebärä	Noun
neka	Verb
nëkängö	Noun
nëkängö-yê	Noun
nenêe	Adjective Noun
nëngö	Adjective Noun
nëngö-zo	Noun
nereka	Verb
nërëkängö	Noun
nëväkîni	Noun
ngâ	Noun Adverb
ngâ tîtene… pëpe	Connective
ngâ-osîi	Adverb
ngâakô	Noun
ngaängangü	Adverb
ngâbôrô	Adjective Noun
ngadï	Noun
ngâgö	Noun
ngâgö tî âtörö	Noun
ngalafo	Noun
ngale	Noun
ngambe	Noun
nganda	Noun
ngandi	Noun
nganga	Noun
ngängä	Noun
ngângângâ	Adverb
ngangi	Noun
ngangî mböndö	Noun
ngangü	Adjective Noun Adverb
ngâo	Noun
ngäöngäö	Noun
ngarä	Noun
ngäsa	Noun
ngäsâ	Noun
ngäsa tî ngonda	Noun
ngäsangbaga	Noun
ngäsëmä	Noun
ngâsi	Noun Verb
ngäsïngö	Noun
ngata	Noun
ngâzi	Noun
ngbä	Noun
ngbâ	Verb
ngbâ na pekô	Verb
ngbâ tî	Verb
ngbâa	Noun
ngbâandâ	Noun
ngbâangbâ	Noun
ngbaba	Noun
ngbädä	Noun
ngbadârâ	Noun
ngbädï	Noun
ngbâko	Noun
ngbâkongö	Noun
ngbakpa	Noun
ngbäkpä	Noun
ngbälâ	Noun
ngbâlo	Noun
ngbana	Noun
ngbändömä	Noun
ngbanga	Noun
ngbängä	Noun
ngbanga nî	Preposition
ngbanga tî	Preposition
ngbanga tî nye	Adverb
ngbanga tî sô	Connective
ngbangaföro	Noun
ngbangandimbö	Noun
ngbangatî	Connective
ngbangäzâ	Noun
ngbângbâ	Noun
ngbangbo	
ngbangbo	Noun
ngbangêlë	Noun
ngbângêrê	Noun
ngbângêrêngû	Noun
ngbängö	Noun
ngbeên	Noun
ngbëndä	Noun
ngbëndä	Noun
ngbëndä	Noun
ngbêndû	Noun
ngbêne	Adjective
ngbengbe	Noun
ngbëngbë	Noun
ngbëngbërë	Adjective
ngbêngberê	Noun
ngbengê	Noun
ngbengë	Noun
ngbêre	Adjective
ngberere	Noun
ngbii	Adverb
ngbîna bê	Noun
ngbö ɳo	Noun
ngbö ɳɔ	Noun
ngböbïtö	Noun
ngbodo	Noun
ngbökorö	Noun
ngbôlô	Noun
ngbon	Noun
ngbondâ	Noun
ngbondö	Adjective
ngbondo	Verb
ngböndöngö	Noun
ngbonga	Noun
ngbongbö	Noun
ngböngbö	Noun
ngbongbôro	Adjective Noun
ngbongbörö	Noun
ngböngï	Noun
ngböngô	Noun
ngböngö	Noun
ngbota	Verb
ngbôto	Noun
ngbotoro	Noun
ngbuka	Noun Verb
ngbukë	Noun
ngbûku	Noun
ngbundangbu	Noun
ngbungbu	Noun
ngbünkängö	Noun
ngbünu	Noun
ngburuka	Noun
ngbuta	Noun
ngê	Adjective
nge	Verb
ngêdê	Noun
ngediri	Noun
ngeênge	Noun
ngëkundü	Noun
ngëlängö	Noun
ngêli	Adjective
ngëmä	Noun
ngembö	Noun
ngendë	Noun
ngenge	Noun
ngëngëlë	Adjective
ngêngêrê	Adjective
ngêngêrêngê	Adjective
ngëngö	Adjective Noun
ngenyë	Noun
ngënye	Noun
ngenyö	Noun
ngênzä	Noun
ngënzë	Noun
ngêrë	Noun
ngêrë	Noun
ngerewa	Noun
ngëtö	Noun
ngi	Noun
ngîâ	Noun
ngiba	Noun
ngii	Adjective
ngîilê	Noun
ngile	Noun
nginza	Noun
ngira	Noun
ngïrängö	Noun
ngîri	Verb
ngïrïkî	Noun
ngïrïngö	Noun
nglävö	Noun
ngo	Noun
ngô	Verb
ngö ŋɔ	Noun
ngö ŋo	Verb
ngoalö	Noun
ngobi	Noun
ngobita	Noun
ngobo	Noun
ngôbo	Noun
ngodö [ɔ]	Noun
ngoi	Noun
ngoi tî dê	Noun
ngoi tî kötä dê	Noun
ngoi tî ngûnzapä	Noun
ngökënë	Noun
ngoko	Verb
ngököngö	Noun
ngoli	Noun
ngölï	Noun
ngolo	Noun
ngôlö	Noun
ngölö	Noun
ngôlömosobe	Noun
ngömä	Noun
ngombe	Noun
ngômbê	Noun
ngômbê-kombo	Noun
ngombï	Noun
ngömbo	Adjective
ngonda	Noun
ngôndo	Noun
ngôndörömângo	Noun
ngonga	Noun
ngôngbi	Verb
ngöngbïngö	Noun
ngöngö	Noun
ngongo	Noun
ngôngo	Noun
ngôngô	Noun
ngongoa	Noun
ngöngonö	Noun
ngongü	Noun
ngonzo	Noun
ngôokâ	Noun
ngôongô	Noun
ngoro ŋɔrɔ	Noun
ngoro ŋoro	Noun Verb
ngorokë	Noun
ngoromubë	Noun
ngôrôngbi	Noun Verb
ngöröngbïngö	Noun
ngorongbö	Noun
ngöröngbö	Noun
ngöröngö	Noun
ngoropangi	Noun
ngötï	Noun
ngoto	Noun
ngowên	Noun
ngoyä	Noun
ngrözâ	Noun
ngû	Noun
ngu	Noun
ngû îngö	Noun
ngû na ngû	Adverb
ngû nzapä	Noun
ngû tî bängâ	Noun
ngû tî kâsa	Noun
ngû tî këkë	Noun
ngû tî lê	Noun
ngû tî lê tî këkë	Noun
ngû tî mbëtï	Noun
ngû tî me	Noun
ngû tî nyöngö	Noun
ngû tî terê	Noun
nguba	Noun
ngubë	Noun
ngubî	Noun
ngubü	Noun
ngüënyë	Noun
ngui	Noun
ngûkâsa	Noun
ngukü	Noun
ngûlavu	Noun
ngûlayänü	Noun
ngûli	Noun
ngûmbâ	Noun
ngûmba	Verb
ngûme	Noun
ngumu	Noun
ngundë	Noun
ngundë tî gîgî	Noun
ngûngbi	Noun Verb
ngüngü	Noun
ngungu	Noun
ngungu tî monzambë	Noun
ngûngunzä	Adjective
ngunu	Noun
ngunzä	Noun
ngûnzapä	Noun
ngürü	Noun
ngûru	Noun
nguru	Noun Verb
ngurugbïä	Noun
ngûrûngbi	Verb
ngürüngbïngö	Noun
ngürüngö	Noun
ngusü	Noun
ngûyângâ	Noun
nguzü	Noun
nî	Mark of ipseity Pronoun
nï	Verb Pronoun
nî laâ	Preposition
nî laâ sï	Adverb
nïähô	Noun
niebe	Noun
nîgisi	Noun
nïkpä	Noun
nilöon	Noun
nîndya	Noun
ningä	Noun
nînga	Verb
nïngängö	Noun
nîri	Adjective
nïväkîni	Noun
nökö	Noun
nömörö	Noun
nônkpo	Verb
nönkpöngö	Noun
noon	Noun
noro	Noun
nörö	Noun
nyama	Noun
nyama tî ngû	Noun
nyama tî yâ	Noun
nyângzängzambërë	Noun
nyâü	Noun
nye	Pronoun
nye?	Interjection
nyëkpä	Noun
nyenye	Noun
nyenyekê	Adverb
nyerë	Noun
nyigbïä	Noun
nyïkonga	Noun
nyîlikôlo	Noun
nyïlitï	Noun
nyimbëtï	Noun
nyïndû	Noun
nyïngambi	Noun
nyïngêrë	Noun
nyïpande	Noun
nyïwanda	Noun
nyö	Verb
nyö mbere	Verb
nyö me	Verb
nyö mênë	Verb
nyögbïä	Noun
nyön	Verb
nyöngö	Noun
nyöngö-mânga	Noun
nyöngö-mbere	Noun
nyöngö-me	Noun
nyöngö-mênë	Noun
nzâ	Noun
nzä	Noun
nzabï	Noun
nzaï	Noun
nzalakodi	Noun
nzâli	Noun
nzambö	Noun
nzânda	Noun
nzängä	Noun
nzângi	Noun
nzanza	Noun
nzânzâambôlï	Noun
nzânzâmboli	Noun
nzänzärä	Noun
nzanzë	Noun
nzanzo	Noun
nzapä	Noun
nzara	Noun
nzara a sara	Verb
nzara tî dëngö	Noun
nzara tî ngû	Noun
nzara tî ngû a sara	Verb
nzawe	Noun
nzayü	Noun
nze	Noun
nzêen	Verb
nzêgê	Noun
nzegele	Noun
nzekë	Noun
nzekede	Noun
nzekete	Verb
nzëkëtëngö	Noun
nzëlëlë	Noun
nzêne	Adjective
nzënë	Noun
nzêne ngbonga	Noun
nzêne nzêne	Adjective
nzênembôsï	Noun
nzengê	Adjective Adverb
nzëngö	Noun
nzenze	Noun
nzêpêrê	Noun
nzere	
nzere	
nzerë	Noun
nzërë	Noun
nzere	Verb
nzërëngö	Adjective
nzërëngö terê	Noun
nzerere	Noun
nzêrerê	Noun
nzetï	Noun
nzï	Noun Verb
nziä	Noun
nzïä	Noun
nzia	Noun
nzibo	Noun
nzîlângöngökpakpa	Noun
nzilo	Noun
nzîna	Adjective Noun Verb
nzïnängö	Noun
nzïngä	Noun
nzînga	Verb
nzïngö	Noun
nzîngo	Noun
nzira	Noun
nzö	Noun
nzöbä	Noun
nzöbê	Noun
nzôkô, ngobo	Noun
nzôlogê	Noun
nzombö	Noun
nzömbö	Noun
nzôngbô	Noun
nzöngörö	Noun
nzönî	Adjective Adverb
nzönî gängö	Noun
nzönî kûê	Adjective
nzöpäsä	Noun
nzorôko	Noun
nzototo	Noun
nzumba	Noun
oberzîne	Noun
obu	Noun
ôdô	Noun
ôke	Adverb
ôko	Adjective Adverb
ôko äpe	Adverb
ôko ôko	Adverb Pronoun
ôkpô	Noun
okü	
olîve	Noun
omenë	
ôndö	Noun
ôngbô, bakâ	Noun
ôngo	Noun
öngö	Verb
öngöngö	Noun
öngöngö-kûâ	Noun
ônka	Noun
opërëe	Noun
öpö	Noun
orânze	Noun
oro	Noun
ôrô	Noun
oro	Verb
ôro	Verb
ôro korobô	Verb
oro-ôrô	Noun
öröngö	Noun
öröngö-korobô	Noun
osîi	Adverb
osïö	
otâ	
ôta	Noun
otöo	Noun
ôtoro	Noun
ôvûrû	Noun
ôye	Interjection
pa	Noun
pâ	Noun
pä	Verb
pä ïrï	Verb
pagerë	Noun
paka	Noun
paka-pâka	Noun
pakapâka	Noun
pakara	Noun
pakëe	Noun
päkö	Noun
päkôle	Noun
pakuni	Noun
palâse	Noun
palâta	Noun
palî	Noun
palö	Noun
pambo	Noun
pâmbo	Noun
pâmbotï	Noun
pan	Adverb
panarïi	Noun
pandä	Adjective
pândä	Noun
pânda	Verb
pânda terê	Verb
pandalöon	Noun
pändängö	Noun
pande	Noun
pandë	Noun
pandëbongö	Noun
pandêfu	Noun
pandesümä	Noun
pandetoli	Noun
pandi	Noun
pandôo	Noun
pängä	Noun
pängö ndö	Noun
pängö ndö	Noun
pängö-ïrï	Noun
panûngû	Noun
panzâka	Verb
panzêe	Noun Verb
panzëngö	Noun
pâo	Noun
paogerê	Noun
pâpä	Noun
päpä	Noun
papa	Noun Verb
papa tî gozo	Noun
papa tî pëmbë	Noun
papaya	Noun
papâye	Noun
pärä	Noun
pärä tî wâ	Noun
parâba	Noun
paradonêe	Verb
paradôon	Noun
päräkôndo	Noun
parara	Noun
parâsi	Noun
parâsi tî kä	Noun
parâsi tî kua	Noun
päräsombo	Noun
parâta	Noun
päsä	Noun
pasêe	Verb
päsëmä	Noun
päsëngö	Noun
päsëpôro	Noun
pasêwüngö	Noun
pâsi	Noun
pâsi tî mosoro	Noun
pasïön	Noun
pasûla	Verb
päsülängö	Noun
pasûndâ	Noun
patâ	Adjective
pâta	Noun
patapâta	Noun
pätärä	Noun
pâvoro	Adjective Noun
päwä	Noun
päwä tî ngû	Noun
pawüngö	Noun
pâyö	Noun
pë	Verb
pe	Verb
pêelëe	Noun
pegerê	Noun
pekë	Noun
pekô	Noun
pekô tî bêkömbite	Noun
pekô tî gerê	Noun
pekô tî li	Noun
pekô tî mabôko	Noun
pekôda	Noun
pekôdûnîa	Noun
pêlêma	Noun
pêmba	Noun
pëmbë	Noun
pëmbë tî bëkpä	Noun
pëmbë tî doli	Noun
pendâ	Noun
pendâgô	Noun
pendâkua	Noun
pendâmbö	Noun
pendângoi	Noun
pendânzërë	Noun
pendâsê	Noun
pendere	Adjective Noun
pendo	Noun
pëngö	Adjective Noun
penze	Adjective Noun
penzelö	Noun
pënzëngbonga	Noun
penzepa	Noun
penzo	Adverb
pêöo	Noun
pëpe	Adverb
pepe	Noun
pëpë	Noun
pepe	Verb
pepêe	Adjective
pêpëlêpendo	Noun
pëpëngö	Noun
pepenyömö	Noun
pepere	Verb
pëpërëngö	Noun
pêrë	Noun
perê	Noun
pere	Verb
peredêe	Verb
përëdëngö	Noun
pereke	Verb
përëkëngö-zo	Noun
pêrêmä	Noun
përëngö	Noun
perepupu	Noun
pesïi	Noun
pêsu	Noun
peta	Verb
pëtängö	Noun
pête	Noun
pëtë	Noun
pete	Verb
pete gôro	Verb
peteke	Verb
pëtëkëngö	Noun
pëtëngö	Noun
pëtëngö-gôro	Noun
petere	Verb
pëtërëngö	Noun
peya	Noun
peyêe	Verb
pëyëngö	Noun
pia	Adjective Verb Adverb
pialö	Noun
pïämë	Noun
pîdä	Adjective Noun
pîdâ	Noun
pîda	Verb
pïdängö	Adjective Noun
piî	Adjective
pîka	
pika	Noun
pîka	Noun Verb
pîka balöon	Verb
pîka baravöo	Verb
pîka bê	Verb
pîka bîâ	Verb
pîka birä	Verb
pîka gobo	Verb
pîka kate	Verb
pîka lê	Verb
pîka li	Verb
pîka lisorö	Verb
pîka mabôko	Verb
pîka masïni	Verb
pîka ndembö	Verb
pîka ngombe	Verb
pîka ngû	Verb
pîka pätärä	Verb
pîka sâko	Verb
pîka sînga	Verb
pîka terê	Verb
pîka wên	Verb
pîka yângâ	Verb
pïkängö	Noun
pïkängö-balöon	Noun
pïkängö-baravöo	Noun
pïkängö-bê	Noun
pïkängö-bîâ	Noun
pïkängö-birä	Noun
pïkängö-gobo	Noun
pïkängö-kate	Noun
pïkängö-lisorö	Noun
pïkängö-mabôko	Noun
pïkängö-masïni	Noun
pïkängö-ndembö	Noun
pïkängö-ngombe	Noun
pïkängö-ngû	Noun
pïkängö-pätärä	Noun
pïkängö-sâko	Noun
pïkängö-sînga	Noun
pïkängö-wên	Noun
pïkängö-yângâ	Noun
pikëe	Noun
pikïri	Noun
pïkôpe	Noun
pinarïi	Noun
pinarïi tî ângbaka	Noun
pïndï	Noun
pindi	Noun
pïndïrï	Noun
pïndïrï tî wâ	Noun
pinîi	Verb
pîri	Adjective Noun
piripîri	Noun
pïrïwä	Noun
pisä	Noun
pîsï	Noun
pisirâ	Noun
pitäan	Noun
pîtî	Adverb
pito	Noun
pitoröo	Noun
pîtôtô	Adjective
pläplämûsu	Noun
pläsï	Noun
pô	Adverb
pö	Noun
pö	Noun
pökö	Noun
polêlê	Adverb
polïo	Noun
polïpa	Noun
pölïtîkï	Noun
polûsu	Noun
pomä	Noun
pôme	Noun
pômesitëre	Noun
pömëtêre	Noun
pônde	Noun
pondoro	Noun
pongä	Noun
pôngâ	Noun
ponga	Verb
pöngängö	Noun
pöngï	Noun
pongi	Verb
pongi-ponga	Adverb
pöngïngö	Noun
pöngïrï	Noun
pongiri	Verb
pöngïrïngö	Noun
pôngô	Noun
pöngö	Noun
ponö	Noun
pönzö	Noun
pôo	Verb
pope	Noun
popö	Adjective Noun
pöpö	Noun
pöpöhötö	Noun
pöpöködörö	Noun
popôto	Noun
popoto	Verb
pöpötöngö	Noun
poro	Adjective
pörö	Noun
pörö	Noun
pörö tî lê	Noun
pörö tî yângâ	Noun
poroko	Adjective
porosö	Noun
pöröterê	Noun
pôsâ	Adjective
pôso	Noun
pösö	Noun
Pötö	Noun
poto	Verb
pötöngö	Noun
potöo	Noun
potopôto	Noun
pozonêe	Verb
pözönëngö	Noun
pulä	Noun
pulûsu	Noun
pumbä	Noun
pûmbû	Noun
pûnda	Noun
pûnda	Noun
pupëe	Noun
pupu	Noun
pupulatëre	Noun
pûpûlenge	Noun
pupuruka	Noun
pupusêse	Noun
purû	Noun
pusä	Noun
puse	Adjective
pûsû	Adjective
püsü	Noun
pûsu	Verb
pûsu längö	Verb
pûsu terê	Verb
püsüngö	Noun
pusupûsu	Noun
pûtu	Noun
râa	Verb
râa zo	Verb
rambâi	Noun
reäl	Noun
rêke	Adverb
retêe	Verb
rëtëngö	Noun
rezïin	Noun
rôbo	Noun
rombêe	Verb
römbëngö	Noun
römbëngö-marä	Noun
römbëngö-zo	Noun
rôo	Verb
rozêe	Verb
rözëngö-yê	Noun
rûmba	Noun
rumbatêe	Verb
rumbatêe zo	Verb
rümbätëngö	Noun
sa	Noun
sä	Noun
sâa	Verb
sâa bipa	Verb
sâa külä tî	Verb
sâa yêgbâ	Verb
saba	Noun
sabânga	Noun
sabângo	Noun
sabôi	Noun
sabûndu	Noun
sâdâka	Noun
safüu	Noun
sägbä	Noun
sâi	Noun
säkä	Noun
sâkârâkâ	Adjective
sâkârâkâ-sakaraka	Adverb
sakatômbo	Noun
sâki	Adjective Noun
sâki otâ	Adjective
sâkikilöo	Noun
sâko	Noun
sakpä	Noun
sakpa	Verb
säkpängö	Noun
sakuumbë	Noun
sälä	Noun
saläde	Noun
samaräa	Noun
sämba	Noun
sambâ	Noun
sämbä	Noun
samba	Verb
samba sämbä	Verb
sämbängö	Noun
sambêla	Noun Verb
sämbëlängö	Noun
sambia	Noun
sân	Noun Preposition
sân tîtene	Connective
sänä	Noun
sana	Verb
sänängö	Noun
sândâga	Noun
sandûgu	Noun
sandûku	Noun
sandûku tî kûâ	Noun
sandûku tî vôte	Noun
sanfutêe	Verb
sänfütëngö	Noun
sângâï	Noun
sängbä	Noun
sangbi	Noun Verb
sangbilêgë	Noun
sängbïngö	Noun
sängï	Noun
sangîâ	Noun
sango	Noun
sängö	Noun
sängö-bipa	Noun
sängö-külä	Noun
sängö-yêgbâ	Noun
sangû	Noun
sanza	Noun
sanzëe	Verb
sânzi	Noun
sânzîrî	Noun
sänzö	Noun
sapa	Noun
särä	Noun
sara	Verb
sâra	Verb
sâra baba	Verb
sâra bê ôkô	Verb
sâra biando	Verb
sâra bôon	Verb
sâra da	Verb
sâra fotöo	Verb
sâra gobo	Verb
sâra goigôi	Verb
sâra gürü	Verb
sâra hînön	Verb
sâra kä	Verb
sâra kâî	Verb
sâra kamënë	Verb
sâra keremba	Verb
sâra kôbe	Verb
sâra ködörö	Verb
sâra kôgarâ	Verb
sâra kônde	Verb
sâra kongö	Verb
sâra kua	Verb
sâra likisï	Verb
sâra lisorö	Verb
sâra mabôko	Verb
sâra makoröo	Verb
sâra mawa	Verb
sâra mayëre	Verb
sâra mbadi	Verb
sâra mbänä	Verb
sâra mbanda	Verb
sâra mbëtï	Verb
sâra mbeto	Verb
sâra mbeto na zo	Verb
sâra mvene	Verb
sâra na bê ûse	Verb
sâra na mabôko ûse	Verb
sâra na mbänä	Verb
sâra ndawo	Verb
sâra ngangü	Verb
sâra ngangü na zo	Verb
sâra ngîâ	Verb
sâra ngonzo	Verb
sâra nzara	Verb
sâra parâba	Verb
sâra pâsi	Verb
sâra pëtë	Verb
sâra pölïtîkï	Verb
sâra sänä	Verb
sâra sänä na zo	Verb
sâra sïönî	Verb
sâra sïönî bê	Verb
sâra sïönî na	Verb
sâra söngö	Verb
sâra tembe	Verb
sâra tënë	Verb
sâra tufa na ndö tî zo	Verb
sâra vundü	Verb
sâra wätäkä	Verb
sâra wûrûwûrû	Verb
sâra yäkä	Verb
sâra yângâ	Verb
sâra yorö	Verb
sâra zo pâsi	Verb
saradîne	Noun
sârânangkora	Noun
särängö	Adjective Noun
särängö-bê-ôkô	Noun
särängö-biando	Noun
särängö-bôon	Noun
särängö-da	Noun
särängö-fotöo	Noun
särängö-goigôi	Noun
särängö-gürü	Noun
särängö-hînön	Noun
särängö-kâî	Noun
särängö-kamënë	Noun
särängö-keremba	Noun
särängö-kôbe	Noun
särängö-ködörö	Noun
särängö-kônde	Noun
särängö-kongö	Noun
särängö-kua	Noun
särängö-lisorö	Noun
särängö-makoröo	Noun
särängö-mawa	Noun
särängö-mayëre	Noun
särängö-mbadi	Noun
särängö-mbänä	Noun
särängö-mbëtï	Noun
särängö-mbeto	Noun
särängö-mbeto na zo	Noun
särängö-mvene	Noun
särängö-ngangü	Noun
särängö-ngangü na zo	Noun
särängö-ngîâ	Noun
särängö-ngonzo	Noun
särängö-nzara	Noun
särängö-parâba	Noun
särängö-pâsi	Noun
särängö-pölïtîkï	Noun
särängö-sänä	Noun
särängö-sänä na zo	Noun
särängö-sïönî	Noun
särängö-söngö	Noun
särängö-tembe	Noun
särängö-tënë	Noun
särängö-vundü	Noun
särängö-wätäkä	Noun
särängö-wûrûwûrû	Noun
särängö-yäkä	Noun
särängö-yê	Noun
särängö-yê na bê ûse	Noun
särängö-yê na mabôko ûse	Noun
särängö-yê na mbänä	Noun
särängö-yorö	Noun
särängö-zo pâsi	Noun
sarapandëe	Noun
sarara	Noun
saratëe	Noun
sarawîsi	Noun
sasâ	Noun
sasa	Noun Verb
sasango	Noun
säsängö	Noun
sasëre	Noun
saterê	Noun
savâa	Verb
sävängö	Noun
savöon	Noun
sawâsi	Adjective Noun
sê	Noun
se	Verb
së	Verb
sêe	Verb
sêe terê	Verb
sêen	Verb
seêsä	Noun
sêgbegô	Noun
sêgbïä-halëzö	Noun
sêgiri	Noun
sêgô	Noun
sêkä	Noun
sêkâ	Noun
seke	Noun
sêkêma	Noun
seketêre	Noun
seko	Noun
sêkü	Noun
sêku	Noun Adverb
sêkuagbe	Noun
sêkûnë	Noun
sëkûrû	Noun
selêka	Noun
selerïi	Noun
sêli	Noun
sêlörö	Noun
semangili	Noun
sembë	Noun
sembë tî bîâ	Noun
sembëkâsa	Noun
sembëkôbe	Noun
sêmîsa	Noun
sen	Noun
sên	Noun
sên-kpakpa	
sên-ngonda	Noun
sêndâ	Noun
sênda kua pa	Noun
sêndâ-yê	Noun
sêndâkônde	Noun
sêndâtënë	Noun
sêndê	Noun
sëndë	Noun
sêndën	Noun
sêndêndê	Noun
sêndowâ	Noun
sënë	Noun
sene	Noun
sêngbi	Noun Verb
sêngbondö	Noun
sêngê	
sêngê	Adjective Adverb
sëngë	Noun
senge	Verb
sêngê sêngê	Adverb
sëngö	Adjective Noun
sëngö-terê	Noun
sênî	Noun
sênkpakpa	Noun
sënngö	Adjective
sênyô	Noun
sênzönî	Noun
sepë	Noun
sepe	Verb
sepela	Verb
sepela-kûâ	Noun
sëpëlängö	Noun
sëpëlängö-ndo	Noun
sëpëlängö-zo	Noun
sêpêlê	Adjective
sëpëngö	Noun
sërä	Noun
sêre	Adjective
sërë	Noun
serë	Noun
serêe	Verb
serêe Gbânzîrî	Noun
serême	Noun
sërôme	Noun
sêse	Noun
sesêe	Adjective Noun
sesêe filëre	Noun
sêsüngö	Noun
sêtâ	Noun
sëtë	Noun
sêterê	Noun
sëwä	Noun
sêwüngö	Noun
sêyâgbâ	Noun
sêyângâ	Noun
sêyângbö	Noun
shâi	Noun
shayêe	Verb
shêkâ	Noun
shîiû	Noun
shokoläa	Noun
shûu	Noun
sî	Connective
sï	Connective Verb Adverb
sï gîgî	Verb
sï sïngö	Verb
siä	Adjective
sibisïi	Noun
sidâa	Noun
sigête	Noun
sïgî	Verb
sïgïngö	Noun
sîi	Noun
sîin	Verb Adverb
simäa	Noun
sindi	Noun
sindimäa	Noun
sinëmä	Noun
singa	
sînga	Noun
singîla	Noun Interjection
sïngö	Noun
sïngö-gîgî	Noun
sïngôme	Noun
sïnngö	Noun
sïnözîte	Noun
sïökpärï	Noun
sion	Noun
sïönî	Adjective Adverb
sïönî bä	Noun
sïönî bê	Noun
sîrâ	Noun
siri	Noun
sirï	Noun
sïrïbï	Noun
sirîki	Noun
sîrîrî	Noun
sisä	Noun
sisagbênga	Noun
sisamû	Noun
sisi	Noun
sisongo	Noun
sizôo	Noun
sö	Noun Verb
so	Verb
sô [so]	Connective Verb Pronoun
sô [sɔ]	Verb
so bê	Verb
sô benda	Verb
sô lörö	Verb
so na ndö tî zo	Verb
sô sï	Connective
sö sö	Verb
sö sösö	Verb
söäkä	Noun
soanyêe	Verb
söänyëngö	Noun
soazïi	Noun
sobêle	Noun
sobîsi	Noun
sobolo	Noun
söë	Noun
sökë	Noun
sökö	Noun
soko	Verb
sokporo	Noun Verb
sökpöröngö	Noun
sömbä	Noun
somba	Verb
sömbängö	Noun
sombë	Noun
sombêe	Noun Verb
sombere	Noun
sombo	Noun Verb
sombokîo	Noun
sömböngö	Noun
sön	Verb
sondoto	Noun
songo	Noun
söngö	Noun
söngö bê	Noun
söngö gô	Noun
söngö li	Noun
söngö lörö	Noun
söngö pëmbë	Noun
söngö sö	Noun
söngö sösö	Noun
söngö yâ	Noun
sönngö	Noun
sôo	Noun
soônga	Noun
soöre	Noun
sooro	Noun
sopë	Noun
sopo	Noun
sore	Noun
sorö	Adjective Noun
sörö	Noun
soro	Noun Verb
soronga	Verb
söröngängö	Noun
söröngö	Noun
sosêti	Noun
sösö	Noun
soso	Verb
sosongo	Noun
sösöngö	Noun
sû	Noun Verb
su	Verb Interjection
sû kpê	Verb
süä	Noun
sua	Verb
sua	Verb
süäli	Noun
suali	Noun
süängö	Adjective Noun
sûî	Adjective Adverb
sukâni	Noun
sûku	Verb
sukûla	Verb
sukûla bê na terê tî zo	Verb
sukûla ngû	Verb
sukûla terê	Verb
sükülängö	Noun
sükülängö-bê na terê tî zo	Noun
sükülängö-ngû	Noun
sükülängö-terê	Noun
süküngö	Noun
süküngö-më	Noun
sûkûru	Noun
sûkûrû-sükürü	Adverb
sulêe	Verb
sülëngö	Noun
sûlupita	Noun
sümä	Noun
suma	Verb
sümä mbëtï	Noun
sümälisorö	Noun
sümängö	Noun
sûn	Noun
sunga	Verb
süngängö	Noun
sungbä	Noun
sungba	Verb
süngbängö	Noun
sûngbi	Verb
süngbïngö	Noun
süngö	Noun
süngö-lörö	Noun
süngö-mbëtï	Noun
sûngûperênge	Noun
sûpa	Noun
sûpu	Noun
surä	Noun
sura	Verb
sürängö	Noun
sûru	Verb
sûru bê	Verb
sûru lê	Verb
sûrûngbi	Verb
sürüngbïngö	Noun
sürüngö	Adjective Noun
sürüngö-zo	Noun
susu	Noun
susura	Verb
süsürängö	Noun
sûu	Noun
suûya	Noun
ta	Noun
tâ	Noun
tä	Verb
tä gbûgbû	Verb
tä ndembö	Verb
taâ	Adjective Adverb
taâle	Noun
taângû	Noun
taâtënë	Noun
taba	Noun
tâbambî	Noun
tâbolo	Noun
tabolôo	Noun
tägä	Noun
tâgba	Noun
tâgbïä	Noun
tâhüzü	Noun
tâkâ	Adjective
tâkâ pa	Noun
tâkâ pandë	Noun
tâkâ sû	Noun
tâkâ tângo	Noun
tâkâ tënë	Noun
tâkâfi	Noun
tâkândo	Noun
takasï	Noun
takêe	Verb
täkëngö	Noun
tâkôndo	Noun
tâkongä	Noun
täkpälë	Noun
takûâmbëlë	Noun
tâla	Noun
tâlavu	Noun
tâle	Noun
tâlitï	Noun
tambö	Noun
tambûla	Noun Verb
tämbülängö	Noun
tamburuwâ	Noun
tâmosia	Noun
tâmuru	Noun
tänä	Noun
tanda	Verb
tändängö	Noun
tanga	Noun
tânga	Verb
tängängö	Noun
tangawïsi	Noun
tângbi	Verb
tängbïngö	Noun
tängbïngö-kua	Noun
tângbö	Noun
tangë	Noun
tangô	Noun
tängö	Noun
tângo [táŋo]	Noun
tângo [táŋɔ]	Noun
tângo tî bängö-yâ	Noun
tângömbo	Noun
tângû	Noun
täpandë	Noun
tapïi	Noun
târa	Noun
tarä	Noun
tara	Verb
tara ndo	Verb
tara terê	Verb
tärängö	Noun
tärängö-ndo	Noun
tärängö-yê	Noun
târârâ	Adjective
taratärä	Noun
târâwârâ	Adjective
tâse	Noun
tâsi	Noun
tasïon	Noun
tâsökö	Noun
tasôon	Noun
tâtâlîndâ	Noun
tatalïta	Noun
tatärä	Noun
tatara	Verb
tatara ndo	Verb
tätärängö	Noun
tätärängö-ndo	Noun
tatë	Adjective
tate	Verb
tätëngö	Noun
taungê	Noun
tawâ	Noun
tawên	Noun
tayëre	Noun
taza	Noun
tê	Noun
te	Verb
te bê	Verb
te gîgî	Verb
te kä	Verb
te mbere	Verb
te nginza	Verb
te pëmbë	Verb
te terê	Verb
têdua	Noun
têendêlê	Noun
têke	Noun
telëe	Noun
tembe	Noun
tembe na tembe	Noun
tembutu	Noun
temë	Noun
tën	Noun
tende	Noun
tênë	Noun
tënë	Noun
tene	Verb
tene gügümä	Verb
tene lisorö	Verb
tene mvene	Verb
tene tënë	Verb
tene tënë na gbe tî gô	Verb
tënë tî	Preposition
tënë tî bê	Noun
tënë tî nye	Adverb
tënë tî sô	Connective
tenegalan	Noun
tënëngö	Noun
tënëngö gügümä	Noun
tënëngö lisorö	Noun
tënëngö mvene	Noun
tënëngö tënë	Noun
têngana	Noun
têngbi	Noun Verb
têngbi terê	Verb
tëngbïngö	Noun
tëngbïngö	Noun
tëngbïngö-terê	Noun
tëngö	Noun
tëngö-bê	Noun
tëngö-mbere	Noun
tëngö-nginza	Noun
tëngö-pëmbë	Noun
tëngö-terê	Noun
tëngö-yê	Noun
tëngö-zo	Noun
tenpäan	Noun
têrê	Noun
terê	Noun Pronoun
tere	Noun Verb
terê	Verb
terê anzere	Verb
terê tî da	Noun
terê tî këkë	Noun
terê tî lêgë	Noun
terê tî li	Noun
terêkate	Noun
tërëngö	Noun
têsurikômbo	Noun
tëtänôse	Noun
tëtëmbë	Noun
têtêngbë	Noun
tetere	Verb
tëtërëngö	Noun
tëtï	Preposition
tëtï nye	Adverb
tëtï sô	Connective
tëyakë	Noun
teyeli	Noun
têyombo	Noun
tî	Connective Preposition
tï	Noun
tï	Verb
tî âla	Adjective Pronoun
tî ë	Adjective Pronoun
tî lâ na lâ	Adjective
tî lo	Adjective Pronoun
tî löndö na	Preposition
tî löndö na ngoi sô	Adverb
tî löndö na… asï na	Preposition
tï mbênî yê	Verb
tî mbï	Adjective Pronoun
tî mo	Adjective Pronoun
tï na lêgë	Verb
tî nye	Pronoun
tï zo	Verb
tia	Noun
tïä	Noun
tîa	Verb
tîâbëngë	Noun
tiabïngï	Noun
tïänâtë	Noun
tïängö	Adjective Noun
tîêma-konô	Noun
tïföyîde	Noun
tikîsa	Verb
tïkïsängö	Noun
tîkö	Noun
tîko	Verb
tîko tî dengbe	Noun
tïköngö	Noun
tînga	Verb
tînga-wâ	Noun
tïngängö-wâ	Noun
tîngbi	Noun Verb
tîngbi terê	Verb
tïngbïngö	Noun
tïngö	Noun
tîngo	Verb
tïngö na lêgë	Noun
tîngo wâ	Verb
tïngöngö-wâ	Noun
tîo	Verb
tïöngö	Noun
tîôtîôrô	Noun
tiri	Noun Verb
tirika	Verb
tïrïkängö	Noun
tîrîngbi	Verb
tïrïngbïngö	Noun
tïrïngö	Noun
tisä	Noun
tîsa	Verb
tîsângbi	Verb
tïsängbïngö	Noun
tïsängö-ndö	Noun
tisi	Noun
tîta	Verb
tïtängö	Noun
tîtene	Connective
titiri	Noun
tiuko	Noun
tö	
tö	Adjective Noun Verb
tô	Noun
to	Noun Verb
tö mbëlä	Verb
tö mböngö	Verb
tö ndâ	Verb
to pupu	Verb
tö sämba	Verb
to sînga	Verb
töbambî	Noun
töbölösöngä	Noun
töbuä	Noun
tögbätä	Noun
tögbïä	Noun
toko	Noun
tokua	Noun Verb
tôl	Noun
tolï	Noun
tolikïi	Noun
tölitï	Noun
tölito	Noun
tôlo	Noun
tomâti	Noun
tomâti tî âmunzû	Noun
tomâti tî âmunzû	Noun
tomba	Noun Verb
tomba wâlï	Verb
tomba zo	Verb
tömbängö	Noun
tömbängö wâlï	Noun
tömbängö-nyama	Noun
tömbängö-zo	Noun
tômbô	Noun
tombôka	Noun Verb
tömbökängö	Noun
tombûka	Verb
töndâ	Verb
töndö	Noun
tondo	Verb
tondo pekô tî	Verb
töndöngö	Noun
töndöngö pekô tî yê	Noun
töndöngö-yê	Noun
tôndôrô	Adjective
töndörözôrö	Noun
tonga	Noun
töngana	Connective
töngana nye	Adverb
tongasô	Adverb
tôngbi	Verb
töngbïngö	Noun
tôngbö	Noun
töngbö	Noun
töngö	Adjective Noun
tongo	Noun
töngö-mbëlä	Noun
töngö-mböngö	Noun
töngö-ndâ	Noun
töngö-pupu	Noun
tongolo	Noun
töngömbo	Noun
tongondolo	Noun
tongoro	Noun
tôngua	Verb
tönguängö	Noun
tono	Verb
tönöngö	Noun
toô	Noun
toô kokpî	Noun
topa	Noun
töpa	Noun
tope	Noun
torô	Noun
törö	Noun
torokësë	Noun
torola	Noun
torôo	Adverb
torôrô	Adverb
torôtorô	Adverb
totä	Noun
toto	Noun Verb
tötölîyö	Noun
tötöngö	Noun
tôtôrotô	Noun
töturûgu	Noun
töwä	Noun
trïin	Noun
trôhohö	Noun
tropâjï, mbôtën, ïnziä, kôrôbodyo	Noun
tua	Verb
tüängö	Noun
tubu	Noun
tue	Noun
tufa	Noun
tui	Adjective
tuin	Adjective
tukâa	Noun
tukë	Adjective
tuke	Verb
tükëngö	Noun
tukîa	Noun
tukîa tî kupu	Noun
tûku	Noun
tûku	Verb
tûku ngo	Verb
tûku ngû tî yângâ	Verb
tûku ngûlê	Verb
tûku zegë	Verb
tukulu	Noun
tüküngö	Noun
tüküngö ngo	Noun
tüküngö-ngûlê	Noun
tulä	Adjective Noun
tula	Verb
tülängö	Adjective Noun
tule	Noun
tülütë	Noun
tumba	Verb
tumba na gîgî	Verb
tümbängö	Noun
tûmbe	Noun
tüngë	Noun
tüngïä	Noun
tungu	Noun
turu	Noun
turûgu	Noun
turûgukpälë	Noun
turunêe	Verb
turunêe terê	Verb
türünëngö	Noun
tûrûnevîse	Noun
tûrûngu	Noun
turûrutu	Adjective
tutä	Noun
tuta	Verb
tütäkä	Noun
tutaka	Verb
tütäkängö	Noun
tütängö	Noun
tûtûlutûu	Noun
tûtûrû	Noun
tutûu	Adjective
tûu	Adverb
tûutûu	Noun
tuzeng	Noun
tyâ	Verb
tyängö	Noun
tyâtyo	Noun
tyôtyôrô	Noun
uga	Noun
ümvü	Noun
ûnzû	Noun
ûse	
va	Adjective Adverb
vâ	Adverb
vaä	Noun
vâkâ	Adjective
vaka	Noun
vâkâ-vaka	Adverb
vârä	Noun
vâtâtâ	Adverb
vavâra	Adjective
vävärä	Noun
vavara	Verb
vävärängö	Noun
veke	Noun
vekë	Noun
velöo	Noun
velûru	Noun
venë	Noun
venge	Noun
vêre	Noun
vi	Noun
vidoli	Noun
vîi	Verb Adverb
vîi pekô	Verb
vïngö	Noun
vïngö-pekô	Noun
vînye	Noun
vïtämîne	Noun
vivîi	Adjective
viyëe	Adjective
vîzavïi	Adverb
vo	Verb
vö	Verb
vo ngêrë	Verb
voazïin	Noun
vömä	Noun
vôn	Noun
vongbâ	Noun
vöngö	Noun
vöngö yê	Noun
voro	Verb
voro lê	Verb
voro terê na zo	Verb
vöröngö	Noun
vöröngö-terê na zo	Noun
vôte	Noun
votêe	Verb
vötëngö	Noun
vovoro	Noun
vü	Verb
vukö	Adjective
vûko	Verb
vukö lê	Noun
vüköngö	Adjective Noun
vüköngö-ndö	Noun
vulä	Noun
vula	Verb
vulanga	Verb
vülängängö	Noun
vülängö	Noun
vümä	Noun
vundü	Noun
vûnga	Verb
vungbö	Noun
vüngö	Adjective Noun
vurü	Adjective Noun
vuru	Verb
vurü makâko	Noun
vuru yâ tî tënë	Verb
vürüngö	Adjective Noun
vürüngö yâ tî tënë	Noun
vuvu	Noun
wâ	Adjective Noun
wa	Adjective Noun Verb
wâ tî dädä	Noun
wa tî kûâ	Noun
wâ tî zâbolo	Noun
wabâda	Noun
wabâda tî halëzo	Noun
wabanga	Noun
wabätängö	Noun
wabätängö nginza	Noun
wabätängö-bâgara	Noun
wabêafrîka	Noun
wabï	Noun
wabindi	Noun
wabïngökpälë	Noun
wabirä	Noun
waboro	Noun
wabörö	Noun
wabubûta	Noun
wâdädä	Noun
wadëngö-büzë	Noun
wadëngö-këkë	Noun
wadëngö-yäkä	Noun
wado	Noun
wafängö-mbëtï	Noun
wafängö-ngbanga	Noun
wafängö-yäkä	Noun
wâfi	Noun
wafinön	Noun
wafönö	Noun
wafufulafu	Noun
wafüngö-bongö	Noun
wagamvulê	Noun
wagbötöngö-kutukutu	Noun
wagbüngö-kökö	Noun
wagïngö-tënë	Noun
waginon	Noun
wagôsînga	Noun
wahânda	Noun
wahu	Noun
wahülë	Noun
wakä	Noun
wakânga	Noun
wakângö-yê	Noun
wakâra	Noun
wakekere	Noun
wakëngö zo	Noun
wakëngö-wâlï	Noun
wakëngö-wandê	Noun
wakëngö-zo	Noun
wakînda	Noun
wakïön	Noun
wakîte	Noun
waködä	Noun
wakodë	Noun
wakômbe	Noun
wakônde	Noun
waköndö	Noun
wakosâra	Noun
wakpälë	Noun
wakpëngö na kutukutu	Noun
wakpökä	Noun
wakpongbö	Noun
wakua	Noun
wakûâ	Noun
wakuasû	Noun
waküdä	Noun
wakûku	Noun
wakunda	Noun
wakundi	Noun
wakutukutu	Noun
wala	Connective
walâ!	Interjection
walaparäa	Noun
walêgë	Noun
walembë	Noun
walesüä	Noun
walêto	Noun
walï	Noun
wâlï	Noun
wâlï bokôo	Noun
wâlï gaduru	Noun
wâlï kôndo	Noun
wâlï mbârâtâ	Noun
wâlï ngäsa	Noun
wâlï popö	Noun
wâlï taba	Noun
wâlï tï pitäan	Noun
wâlïgbïä	Noun
walïï	Noun
walîkirî	Noun
walikûne	Noun
walimo	Noun
wâlïmüä	Noun
wâlïndü	Noun
walingangü	Noun
wâlïnyama	Noun
walisorö	Noun
walö	Noun
walombë	Noun
wamäbê	Noun
wamada	Noun
wamafï	Noun
wamakoröo	Noun
wamandako	Noun
wamandakua	Noun
wamändängö-kua	Noun
wamändängö-mbëtï	Noun
wamändängö-yê	Noun
wamängö	Noun
wamasûa	Noun
wamawa	Noun
wamba	Noun
wambänä	Noun
wambere	Noun
wambeso	Noun
wambëtï	Noun
wambongo	Noun
wambûki	Noun
wambürü	Noun
wameba	Noun
wamokondo	Noun
wamopï	Noun
wamosoro	Noun
wamoyayäa	Noun
wamozoko	Noun
wamüä	Noun
wamvene	Noun
wanda	Noun
wandarä	Noun
wandawo	Noun
wandê	Noun
wandêndïä	Noun
wandiâ	Noun
wandïrï	Noun
wandôli	Noun
wandûndu	Noun
wängä	Noun
wanganga	Noun
wangbandârâ	Noun
wangböngï	Noun
wangën	Noun
wangêrë	Noun
wangiba	Noun
wanginza	Noun
wängö	Noun
wängö-bê	Noun
wangombï	Noun
wangunu	Noun
wanguru	Mark of ipseity Noun
wanyïpande	Noun
wanyôgbïä	Noun
wanzângo	Noun
wanzï	Noun
wanzïngä	Noun
wanzöpa	Noun
wapande	Noun
wapandesümä	Noun
wapandetoli	Noun
wapäsä	Noun
wapekôdûnîa	Noun
wapëtë	Noun
wapïämë	Noun
wapïkängö ngömbï	Noun
wapito	Noun
wapölïtîki	Noun
wapopô	Noun
wara	Verb
wara gô	Verb
wara gô	Verb
wara kobêla	Verb
wara lêge	Verb
wara ngîâ	Verb
wara sümä	Verb
wara terê	Verb
wârâga	Noun
wärängö	Noun
wärängö-gô	Noun
wärängö-gô	Noun
wärängö-gô	Noun
wärängö-kobêla	Noun
wärängö-lêge	Noun
wärängö-ngîâ	Noun
wärängö-sümä	Noun
wärängö-yê	Noun
wärängö-zo	Noun
wäsâ	Noun
wasärängö-da	Noun
wasärängö-kua	Noun
wasärängö-mbëtï	Noun
wasärängö-ta	Noun
wasêndâ	Noun
wasêndâ kuräa	Noun
wasësëngö	Noun
wasêyângâ	Noun
wasindimäa	Noun
wasînga	Noun
wasîngambëtï	Noun
wasîngamê	Noun
wasîngasû	Noun
wasïökörö	Noun
wasïökpärï	Noun
wasombere	Noun
wasombo	Noun
wasöngö	Noun
wasöngö zo	Noun
wasopo	Noun
wasüngö-mbëtï	Noun
wasüngö-zo	Noun
wasüngö-zo	Noun
wätäkä	Noun
watënë	Noun
watëngö-nyama	Noun
watëngö-pêrë	Noun
watëngö-yê	Noun
watëngö-zo	Noun
watiri	Noun
wato	Noun
watô	Noun
watö	Noun
watokua	Noun
watöndöngö-yê	Noun
watôngbi	Noun
watöngö sango	Noun
watongolo	Noun
watuke	Noun
waturu	Noun
watutä	Noun
watütängö-yê	Noun
wavenge	Noun
wavöngö-yê	Noun
wavöngö-zo	Noun
wavôte	Noun
wävötëngö-zo	Noun
wâwa	Adverb
wawängö	Noun
wawësë	Noun
wawësëngö-ndö	Noun
wawörö	Noun
wayëngö-tënë	Noun
wayërë	Noun
wayïndä	Noun
wayongba	Noun
wayongo	Noun
wazën	Noun
wazibä	Noun
we	Verb
wêen	Verb
wên	Noun
wên na wên	Adverb
wênndembö	Noun
wênngö	Noun
wênngö-wato	Noun
wênngö-wato	Noun
wënyën	Noun
wêre	Verb
wërëngö	Noun
wese	Verb
wësëngö	Noun
wetêkpili	Noun
wî	Noun
wï	Noun
wîya	Noun
wo	Verb
wo bê	Verb
wo terê	Verb
wögbïä	Noun
wôko	Verb
wôkôbôlô	Adjective
wököngö	Adjective Noun
wököngö-küä	Noun
wokoso	Verb
wökösöngö	Noun
woli	Noun
wôlîkemâne	Noun
wombö	Noun
wömüä	Noun
wöngö	Adjective Noun
wöngö-bê	Noun
wöngö-li	Noun
wöngö-terê	Noun
wôo	Verb
wôotï	Verb
woro	Adjective
wororo	Adjective
wötïngö	Adjective Noun
wôtoro	Noun
woyâ	Noun
woza	Verb
wözängö	Noun
wözängö-yê	Noun
wözängö-zo	Noun
wu	Verb
wü	Verb
wu bê	Verb
wu li	Verb
wu ponö	Verb
wu terê	Verb
wûku	Verb
wüküngö	Adjective Noun
wüngö	Adjective Noun
wüngö-bê	Noun
wüngö-ïrï	Noun
wüngö-li	Noun
wüngö-ponö	Noun
wüngö-terê	Noun
würü	Noun
wûrûrû	Noun
wûrûwûrû	Noun
wûsûwusu	Adjective Noun
wûyâwuya	Adjective Noun
yâ	Noun
ya	Verb
yâ tî gbägbä	Noun
yâ tî mabôko	Noun
yâa	Verb
yâbîâ	Noun
yâda	Noun
yâdöngö	Noun
yagbïä	Noun
yâgë	Noun
yäkä	Noun
yakepaka	Noun
yakêrê	Adjective Adverb
yakêrêsa	Noun
yakôo	Noun
yälängä	Noun
yalö	Noun
yämbä	Noun
yamba	Verb Adverb
yamba na	Preposition
yämbägerê	Noun
yämbängö	Noun
yämbätï	Noun
yämbôrô	Noun
yändä	Noun
yândo	Noun
yandü	Noun
yângâ	Noun
yângâ	Verb
yângâ da	Noun
yângâ tî bï	Noun
yângâ tî da	Noun
yângâ tî ködörö	Noun
yângâ tî ndäpêrê	Noun
yângâ tî ndeke	Noun
yângâ tî ngû	Noun
yângâ tî ta	Noun
yängäda	Noun
yangba	Noun
yangbato	Noun
yângbö	Noun
yângbö tî gbïä	Noun
yängö	Adjective Noun
yangö	Noun
yapü	Noun
yâpu	Verb
yäpüngö	Adjective
yäpüngö	Noun
yäsä	Noun
yatögbïä	Noun
yaûli	Noun
yaûru	Noun
yayâ	Noun
yäyû	Noun
ye	Noun
yê	Noun Verb
yë	Verb
yë bîâ	Verb
yë kplön	Noun
yê mîngi tî	Verb
yê pekö	Verb
yê tënë	Verb
yê terë	Verb
yê tî bê	Noun
yê tî gô	Noun
yê tî kamënë	Noun
yê tî kpêne	Noun
yê tî kua	Noun
yê tî mabôko	Noun
yê tî mê	Noun
yê tî ngangü	Noun
yê tî pendere	Noun
yê tî vundü	Noun
yêda	Verb
yêgbâ	Adjective Noun
yêgbâ	Noun
yegema	Verb
yëgëmängö	Noun
yêka	Verb
yeke	Verb Adverb
yeke na	Verb
yeke na kobêla	Verb
yeke sêngê	Verb
yekereza	Noun
yêkia	Verb
yëkïängö	Noun
yêkirö	Noun
yêkua	Noun
yêkûne	Noun
yëmbë	Noun
yêndiâ	Noun
yenga	Noun Verb
yêngâ-yenga	Adverb
yëngängö	Noun
yêngbi	Verb
yëngbïngö	Noun
yëngbïngö-terê	Noun
yenge	Verb
yëngëngö	Adjective Noun
yëngëngö-ndo	Noun
yëngërë	Noun
yengere	Noun Verb
yëngërëngö	Noun
yêngi	Verb
yëngïngö	Noun
yëngö	Noun
yëngö bîâ	Noun
yëngö mîngi	Noun
yëngö pekö tî yê	Noun
yëngö tënë	Noun
yëngö terê	Noun
yëngö-zo	Noun
yëngöda	Noun
yërë	Noun
yeri	Noun
yeyë	Noun
yigbo	Adverb
yîko	Verb
yïköngö	Noun
yimba	Noun Verb
yïmbängö	Noun
yindä	Noun
yinda	Verb
yïndängö	Noun
yïndü	Noun
yîngi	Verb
yîngi gbânda	Verb
yîngô	Noun
yingö	Noun
yingö	Verb
Yingö-Gbïä	Noun
Yingö-Vürü	Noun
yingöva	Noun
yö	Adjective Verb
yo	Adjective Verb
yô	Verb
yô lê	Verb
yo yângâ	Verb
yogbä	Adjective
yogo	Noun
yokota	Verb
yökötängö	Noun
yole	Noun
yombâ	Noun
yombe	Noun
yömbö	Noun
yongba	Noun Verb
yöngbängö	Noun
yöngö	Adjective Noun
yongo	Noun
yongö	Noun
yöngö-ndo	Noun
yongôro	Adjective Noun
yongôro-ngombe	Noun
yorö	Noun
yôro	Verb
yôro mabôko	Verb
yôro na ngû	Verb
yorö tî börö	Noun
yôro tiyöo	Verb
yoröbörö	Noun
yöröki	Noun
yorönden	Noun
yöröngö	Adjective Noun
yöröngö-tiyöo	Noun
yorönzïä	Noun
yorôrô	Adjective Adverb
yoyä	Adjective Noun
yoya	Verb
yöyängö	Adjective Noun
yoyo	Noun
yû	Verb
yü	Verb
yü bongö	Verb
yü pîri	Verb
yüngö	Noun
yüngö-bongö	Noun
yüngö-ndo	Noun
yuru	Verb
yûru	Verb
yuru gbikï	Verb
yuru mênë	Verb
yürüngö	Adjective Noun
zä	
zä	Verb
za	Verb
zä wâ	Verb
zä-yângâ	Verb
zâbolo	Noun
zabula	Verb
zabulanga	Verb
zäbülängängö	Noun
zäbülängö	Noun
zâka	Noun
zâkâ-zaka	Adjective
zakara	Adjective Noun Verb Adverb
zakara tënë	Verb
zäkärängö	Noun
zäkärängö-tënë	Noun
zâkâri	Adjective Verb
zâkâri tënë	Noun
zakarima	Verb
zäkärïmängö	Noun
zäkärïngö	Noun
zakyëe	Noun
zalamëti	Noun
Zâmani	Noun
zamba	Noun
zambala	Noun
zamêe	Adverb
zängö	Adjective Noun
zängö-yângâ	Noun
zarä	Adjective Noun
zâra	Verb
zaragîna	Noun
zaranga	Noun
zärängö	Noun
zari	Noun
zarî	Noun
zavokäa	Noun
zawa, kôgbïä	Noun
zaza	Noun
zäzä	Noun
zazâa	Adjective
zäzämä	Noun
zazama	Verb
zazâra	Adjective
zazo	Noun
zê	Adverb
zë	Verb
zê zê zê	Adverb
zê-zê-zezê	Adverb
zêe	Verb
zegbe	Adjective
zêgbê-zegbe	Adverb
zegbe-zêgbê	Noun
zegbesa	Noun
zegë	Noun
zëkä	Noun
zembe	Noun
zen	Noun
zën	Noun Verb
zênde	Noun
zëndë	Noun
zëndo	Noun
zêne	Verb
zënëngö	Adjective Noun
zêngba	Verb
zëngbängö	Noun
zëngö	Noun
zëngö-dû	Noun
zëngö-ndo	Noun
zënngö	Noun
zënngö-terê	Noun
zënngö-yê	Noun
zere	Verb
zërëngö	Noun
zeze	Noun
zî	Verb
zï	Verb
zî bê na ndö tî yê	Verb
zî lê	Verb
zî pöpö	Verb
zî tënë na li tî zo	Verb
zî terê	Verb
zî vundü na bê	Verb
zî yângâ	Verb
zîa	Verb
zîa bê	Verb
zîa bê na ndö tî yê	Verb
zîa bê na ndö tî yê	Verb
zîa bê na sêse	Verb
zîa lêgë na	Verb
zîa lêgë tî	Verb
zîa lörö da	Verb
zîa mabôko na	Verb
zîa mabôko na ndö tî	Verb
zîa na pendâ	Verb
zîa ndê	Verb
zîa ngîâ na bê	Verb
zîa ngû na terê tî	Verb
zîa simäa	Verb
zîa terê	Verb
zîa tî	Verb
zîa yângâ na	Verb
zîa yângâ na terê tî	Verb
zîa zo na bê	Verb
zîa zo na lêgë	Verb
zîa zo na lêgë	Verb
zian	Noun
zïängö	Noun
zïängö bê	Noun
zïängö lörö da	Noun
zïängö mabôko na	Noun
zïängö mabôko na ndö tî	Noun
zïängö ngîâ na bê	Noun
zïängö ngîâ na bê	Noun
zïängö ngû na terê tî yê	Noun
zïängö yângâ na	Noun
zïängö yângâ na terê	Noun
zïängö zo na lêgë	Noun
zïängö-lêgë	Noun
zïängö-ndê	Noun
zïängö-simäa	Noun
zïbä	Noun
zibola	Noun
zîbongö	Noun
zidoröo	Noun
zigä	Noun
ziga	Verb
zïgängö	Noun
zigidâ	Noun
zima	Noun
zîmâ	Noun
zingbî	Verb
zïngbïngö	Noun
zingîri	Noun
zïngö	Noun
zîngo	Verb
zïngö pöpö	Noun
zïngö terê	Noun
zïngöngö	Noun
zïngöngö-bê	Noun
zinyöon	Noun
zipöo	Noun
zirâa	Noun
zîri	Verb
zïrï	Verb
zïrïngö	Noun
zîzïboro	Adjective
zo	Noun
zö	Verb
zö bê	Verb
zo ôko äpe	Pronoun
zo tî bübä	Noun
zo tî buruma	Noun
zo tî dagbï	Noun
zo tî fängö-terê	Noun
zo tî fängö-zo	Noun
zo tî füngö-bongö	Noun
zo tî füngö-bongö	Noun
zo tî gi nyama	Noun
zo tî gi susu	Noun
zo tî gïngö-nyama	Noun
zo tî gobo	Noun
zo tî goigôî	Noun
zo tî kânga	Noun
zo tî këngö-zo	Noun
zo tî kïön	Noun
zo tî kobêla	Noun
zo tî ködörö	Noun
zo tî kôngô	Noun
zo tî kosâra	Noun
zo tî kötä-bê	Noun
zo tî kua	Noun
zo tî likundû	Noun
zo tî manda kua	Noun
zo tî mawa	Noun
zo tî mbadi	Noun
zo tî mosoro	Noun
zo tî mvene	Noun
zo tî ndawo	Noun
zo tî ngêrë	Noun
zo tî nzï	Noun
zo tî sopo	Noun
zo tî wätäkä	Noun
zo tî yângâ-ûse	Noun
zo tî yongba	Noun
zo tî yorö	Noun
zo tî zegë	Noun
zo wa	Noun
zolë	Noun
zöma	Verb
zömängö	Noun
zömbï	Noun
zômbô-zömbö	Noun
zômongubü	Noun
zonäa	Noun
zonga	Verb
zöngängö	Noun
zongbo	Noun
zöngö	Adjective Noun
zöngö	Noun
zönngö	Noun
zôon	Verb
zorôgo	Noun
zöröndö	Verb
zöröndöngö	Noun
zovukö	Noun
zözömbö	Noun
zûâ	Noun
zuka	Noun
zûku	
zûku	Verb
zûkû-zuku	Adverb
züküngö	Noun
züküngö li	Noun
zunda	Verb
zunda ôônë	Noun
zündängö	Noun
züngö	Noun
zurïi	Noun
zûrü	Noun
zürü	Noun
zuru	Verb
zûru	Verb
zûrû	Verb
zürüngö	Noun
zuruyara	Noun
zûsûka	Connective Adverb
zutêe	Verb
zütëngö	Noun
zûu	Verb